code_ins,lieu_de_residence,hommes,femmes,total,annee
01000,Belgique,5370234,5581032,10951266,2011
02000,Région flamande,3113369,3193269,6306638,2011
03000,Région wallonne,1714482,1811058,3525540,2011
04000,Région de Bruxelles-Capitale,542383,576705,1119088,2011
10000,Province d'Anvers,873370,891403,1764773,2011
11000,Arrondissement d'Anvers,492193,506018,998211,2011
11001,Aartselaar,7082,7229,14311,2011
11002,Anvers,244137,249380,493517,2011
11004,Boechout,6318,6410,12728,2011
11005,Boom,8400,8589,16989,2011
11007,Borsbeek,4928,5279,10207,2011
11008,Brasschaat,17971,19218,37189,2011
11009,Brecht,13767,14034,27801,2011
11013,Edegem,10175,10928,21103,2011
11016,Essen,8969,8950,17919,2011
11018,Hemiksem,5081,5237,10318,2011
11021,Hove (Anvers),3975,4215,8190,2011
11022,Kalmthout,8810,9142,17952,2011
11023,Kapellen (Anvers),12923,13514,26437,2011
11024,Kontich,10161,10423,20584,2011
11025,Lint,4229,4293,8522,2011
11029,Mortsel,12011,12793,24804,2011
11030,Niel,4598,4789,9387,2011
11035,Ranst,9249,9175,18424,2011
11037,Rumst,7330,7426,14756,2011
11038,Schelle,3964,4116,8080,2011
11039,Schilde,9498,9931,19429,2011
11040,Schoten,16308,17292,33600,2011
11044,Stabroek,8893,9068,17961,2011
11050,Wijnegem,4368,4671,9039,2011
11052,Wommelgem,6102,6271,12373,2011
11053,Wuustwezel,9710,9661,19371,2011
11054,Zandhoven,6305,6228,12533,2011
11055,Zoersel,10531,10884,21415,2011
11056,Zwijndrecht,9185,9471,18656,2011
11057,Malle,7215,7401,14616,2011
12000,Arrondissement de Malines,160833,166490,327323,2011
12002,Berlaar,5388,5503,10891,2011
12005,Bonheiden,7083,7573,14656,2011
12007,Bornem,10230,10497,20727,2011
12009,Duffel,8204,8566,16770,2011
12014,Heist-op-den-Berg,19907,20329,40236,2011
12021,Lierre,16598,17525,34123,2011
12025,Malines,40034,41893,81927,2011
12026,Nijlen,10820,11004,21824,2011
12029,Putte,8248,8309,16557,2011
12030,Puurs,8216,8384,16600,2011
12034,Sint-Amands,4036,4108,8144,2011
12035,Sint-Katelijne-Waver,10063,10278,20341,2011
12040,Willebroek,12006,12521,24527,2011
13000,Arrondissement de Turnhout,220344,218895,439239,2011
13001,Arendonk,6428,6427,12855,2011
13002,Baerle-Duc,1294,1300,2594,2011
13003,Balen,10715,10590,21305,2011
13004,Beerse,8430,8605,17035,2011
13006,Dessel,4625,4552,9177,2011
13008,Geel,18784,18699,37483,2011
13010,Grobbendonk,5548,5503,11051,2011
13011,Herentals,13395,13729,27124,2011
13012,Herenthout,4346,4378,8724,2011
13013,Herselt,7313,7073,14386,2011
13014,Hoogstraten,10285,9769,20054,2011
13016,Hulshout,4915,5053,9968,2011
13017,Kasterlee,9220,8918,18138,2011
13019,Lille,8298,8093,16391,2011
13021,Meerhout,4906,4897,9803,2011
13023,Merksplas,4464,4093,8557,2011
13025,Mol,17151,17295,34446,2011
13029,Olen,5916,5868,11784,2011
13031,Oud-Turnhout,6444,6471,12915,2011
13035,Ravels,7326,7116,14442,2011
13036,Retie,5481,5325,10806,2011
13037,Rijkevorsel,5705,5566,11271,2011
13040,Turnhout,20391,20875,41266,2011
13044,Vorselaar,3804,3755,7559,2011
13046,Vosselaar,5264,5211,10475,2011
13049,Westerlo,12170,12030,24200,2011
13053,Laakdal,7726,7704,15430,2011
20001,Province du Brabant flamand,532233,554213,1086446,2011
20002,Province du Brabant wallon,185765,197101,382866,2011
21000,Arrondissement de Bruxelles-Capitale,542383,576705,1119088,2011
21001,Anderlecht,52980,54932,107912,2011
21002,Auderghem,14855,16553,31408,2011
21003,Berchem-Sainte-Agathe,10822,11948,22770,2011
21004,Bruxelles,82454,80756,163210,2011
21005,Etterbeek,21398,23859,45257,2011
21006,Evere,17106,19386,36492,2011
21007,Forest (Bruxelles-Capitale),24804,27034,51838,2011
21008,Ganshoren,10633,12426,23059,2011
21009,Ixelles,40099,42103,82202,2011
21010,Jette,22475,25472,47947,2011
21011,Koekelberg,9935,10326,20261,2011
21012,Molenbeek-Saint-Jean,45504,46229,91733,2011
21013,Saint-Gilles,24299,24140,48439,2011
21014,Saint-Josse-ten-Noode,14160,13198,27358,2011
21015,Schaerbeek,61866,63790,125656,2011
21016,Uccle,36076,42212,78288,2011
21017,Watermael-Boitsfort,11185,13064,24249,2011
21018,Woluwe-Saint-Lambert,23381,28134,51515,2011
21019,Woluwe-Saint-Pierre,18351,21143,39494,2011
23000,Arrondissement de Hal-Vilvorde,291559,307385,598944,2011
23002,Asse,14769,15788,30557,2011
23003,Beersel,11889,12320,24209,2011
23009,Biévène,1056,1099,2155,2011
23016,Dilbeek,19395,20806,40201,2011
23023,Gammerages,4211,4304,8515,2011
23024,Gooik,4540,4564,9104,2011
23025,Grimbergen,16928,18515,35443,2011
23027,Hal (Hal-Vilvorde),17647,18630,36277,2011
23032,Herne,3272,3346,6618,2011
23033,Hoeilaart,5049,5370,10419,2011
23038,Kampenhout,5549,5694,11243,2011
23039,Kapelle-op-den-Bos,4410,4673,9083,2011
23044,Liedekerke,6100,6426,12526,2011
23045,Londerzeel,8789,8989,17778,2011
23047,Machelen (Hal-Vilvorde),6566,7000,13566,2011
23050,Meise,8988,9350,18338,2011
23052,Merchtem,7664,7894,15558,2011
23060,Opwijk,6576,6874,13450,2011
23062,Overijse,11980,12537,24517,2011
23064,Pepingen,2194,2251,4445,2011
23077,Sint-Pieters-Leeuw,15569,16299,31868,2011
23081,Steenokkerzeel,5695,5894,11589,2011
23086,Ternat,7419,7652,15071,2011
23088,Vilvorde,19538,20955,40493,2011
23094,Zaventem,15198,16045,31243,2011
23096,Zemst,10785,11175,21960,2011
23097,Roosdaal,5560,5737,11297,2011
23098,Drogenbos,2282,2653,4935,2011
23099,Kraainem,6479,6923,13402,2011
23100,Linkebeek,2300,2505,4805,2011
23101,Rhode-Saint-Genèse,8728,9224,17952,2011
23102,Wemmel,7366,7922,15288,2011
23103,Wezembeek-Oppem,6554,7151,13705,2011
23104,Lennik,4356,4517,8873,2011
23105,Affligem,6158,6303,12461,2011
24000,Arrondissement de Louvain,240674,246828,487502,2011
24001,Aarschot,13999,14637,28636,2011
24007,Begijnendijk,4901,4947,9848,2011
24008,Bekkevoort,3054,3027,6081,2011
24009,Bertem,4649,4909,9558,2011
24011,Bierbeek,4752,4751,9503,2011
24014,Boortmeerbeek,5878,6000,11878,2011
24016,Boutersem,3840,3851,7691,2011
24020,Diest,11438,11712,23150,2011
24028,Geetbets,2964,2953,5917,2011
24033,Haacht,6948,7235,14183,2011
24038,Herent,9967,10448,20415,2011
24041,Hoegaarden,3261,3371,6632,2011
24043,Holsbeek,4856,4839,9695,2011
24045,Huldenberg,4633,4831,9464,2011
24048,Keerbergen,6244,6499,12743,2011
24054,Kortenaken,3897,3899,7796,2011
24055,Kortenberg,9495,9637,19132,2011
24059,Landen,7540,7901,15441,2011
24062,Louvain,48162,48780,96942,2011
24066,Lubbeek,6851,7034,13885,2011
24086,Oud-Heverlee,5482,5512,10994,2011
24094,Rotselaar,7852,7909,15761,2011
24104,Tervuren,10337,10877,21214,2011
24107,Tirlemont,15757,16946,32703,2011
24109,Tremelo,7299,7277,14576,2011
24130,Léau,4042,4197,8239,2011
24133,Linter,3500,3594,7094,2011
24134,Montaigu-Zichem,11215,11380,22595,2011
24135,Tielt-Winge,5197,5227,10424,2011
24137,Glabbeek,2664,2648,5312,2011
25000,Arrondissement de Nivelles,185765,197101,382866,2011
25005,Beauvechain,3354,3383,6737,2011
25014,Braine-l'Alleud,18449,20098,38547,2011
25015,Braine-le-Château,4776,5040,9816,2011
25018,Chaumont-Gistoux,5641,5846,11487,2011
25023,Court-Saint-Etienne,4851,5092,9943,2011
25031,Genappe,7341,7563,14904,2011
25037,Grez-Doiceau,6197,6561,12758,2011
25043,Incourt,2392,2459,4851,2011
25044,Ittre,3193,3255,6448,2011
25048,Jodoigne,6477,6764,13241,2011
25050,La Hulpe,3608,3853,7461,2011
25068,Mont-Saint-Guibert,3405,3485,6890,2011
25072,Nivelles,12477,13935,26412,2011
25084,Perwez (Nivelles),3958,4139,8097,2011
25091,Rixensart,10439,11426,21865,2011
25105,Tubize,11600,12183,23783,2011
25107,Villers-la-Ville,4996,5163,10159,2011
25110,Waterloo,14080,15584,29664,2011
25112,Wavre,15927,17177,33104,2011
25117,Chastre,3446,3535,6981,2011
25118,Hélécine,1584,1618,3202,2011
25119,Lasne,6893,7183,14076,2011
25120,Orp-Jauche,4045,4218,8263,2011
25121,Ottignies-Louvain-la-Neuve,15171,15840,31011,2011
25122,Ramillies,3065,3089,6154,2011
25123,Rebecq,5188,5389,10577,2011
25124,Walhain,3212,3223,6435,2011
30000,Province de Flandre occidentale,574472,590495,1164967,2011
31000,Arrondissement de Bruges,135882,141461,277343,2011
31003,Beernem,7794,7420,15214,2011
31004,Blankenberge,9208,9888,19096,2011
31005,Bruges,56641,60244,116885,2011
31006,Damme,5436,5409,10845,2011
31012,Jabbeke,6890,6798,13688,2011
31022,Oostkamp,11189,11347,22536,2011
31033,Torhout,9972,10002,19974,2011
31040,Zedelgem,11110,11247,22357,2011
31042,Zuienkerke,1397,1364,2761,2011
31043,Knokke-Heist,16245,17742,33987,2011
32000,Arrondissement de Dixmude,24899,25059,49958,2011
32003,Dixmude,8146,8219,16365,2011
32006,Houthulst,4775,4862,9637,2011
32010,Koekelare,4237,4223,8460,2011
32011,Kortemark,6076,6102,12178,2011
32030,Lo-Reninge,1665,1653,3318,2011
33000,Arrondissement d'Ypres,52728,53427,106155,2011
33011,Ypres,17245,17857,35102,2011
33016,Messines,465,480,945,2011
33021,Poperinge,9890,10093,19983,2011
33029,Wervik,9038,9226,18264,2011
33037,Zonnebeke,6157,6150,12307,2011
33039,Heuvelland,4107,3887,7994,2011
33040,Langemark-Poelkapelle,3947,3899,7846,2011
33041,Vleteren,1879,1835,3714,2011
34000,Arrondissement de Courtrai,139088,143042,282130,2011
34002,Anzegem,7162,7169,14331,2011
34003,Avelgem,4765,4890,9655,2011
34009,Deerlijk,5536,5749,11285,2011
34013,Harelbeke,13369,13392,26761,2011
34022,Courtrai,36507,38361,74868,2011
34023,Kuurne,6394,6573,12967,2011
34025,Lendelede,2806,2841,5647,2011
34027,Menin,16054,16677,32731,2011
34040,Waregem,18067,18526,36593,2011
34041,Wevelgem,15405,15661,31066,2011
34042,Zwevegem,11980,12120,24100,2011
34043,Espierres-Helchin,1043,1083,2126,2011
35000,Arrondissement d'Ostende,74459,77751,152210,2011
35002,Bredene,8186,8197,16383,2011
35005,Gistel,5839,5943,11782,2011
35006,Ichtegem,6974,6886,13860,2011
35011,Middelkerke,9234,9659,18893,2011
35013,Ostende,33692,36040,69732,2011
35014,Oudenburg,4470,4572,9042,2011
35029,De Haan,6064,6454,12518,2011
36000,Arrondissement de Roulers,72282,73651,145933,2011
36006,Hooglede,5061,4906,9967,2011
36007,Ingelmunster,5330,5350,10680,2011
36008,Izegem,13402,13836,27238,2011
36010,Ledegem,4725,4858,9583,2011
36011,Lichtervelde,4253,4237,8490,2011
36012,Moorslede,5414,5445,10859,2011
36015,Roulers,28601,29536,58137,2011
36019,Staden,5496,5483,10979,2011
37000,Arrondissement de Tielt,45434,45238,90672,2011
37002,Dentergem,4176,4135,8311,2011
37007,Meulebeke,5553,5518,11071,2011
37010,Oostrozebeke,3697,3829,7526,2011
37011,Pittem,3381,3339,6720,2011
37012,Ruiselede,2654,2547,5201,2011
37015,Tielt (Tielt),9767,9947,19714,2011
37017,Wielsbeke,4600,4577,9177,2011
37018,Wingene,7060,6832,13892,2011
37020,Ardooie,4546,4514,9060,2011
38000,Arrondissement de Furnes,29700,30866,60566,2011
38002,Alveringem,2539,2410,4949,2011
38008,La Panne,5142,5586,10728,2011
38014,Koksijde,10773,11195,21968,2011
38016,Nieuport,5621,5756,11377,2011
38025,Furnes,5625,5919,11544,2011
40000,Province de Flandre orientale,712246,733585,1445831,2011
41000,Arrondissement d'Alost,135713,140837,276550,2011
41002,Alost (Alost),39695,41367,81062,2011
41011,Denderleeuw,9241,9621,18862,2011
41018,Grammont,16002,16397,32399,2011
41024,Haaltert,8707,8961,17668,2011
41027,Herzele,8545,8671,17216,2011
41034,Lede,8833,9056,17889,2011
41048,Ninove,18133,18968,37101,2011
41063,Sint-Lievens-Houtem,4855,5013,9868,2011
41081,Zottegem,12105,12968,25073,2011
41082,Erpe-Mere,9597,9815,19412,2011
42000,Arrondissement de Termonde,95511,98504,194015,2011
42003,Berlare,7166,7418,14584,2011
42004,Buggenhout,7021,7146,14167,2011
42006,Termonde,21574,22683,44257,2011
42008,Hamme (Termonde),11978,12216,24194,2011
42010,Laarne,6014,6193,12207,2011
42011,Lebbeke,8989,9252,18241,2011
42023,Waasmunster,5184,5315,10499,2011
42025,Wetteren,11603,12216,23819,2011
42026,Wichelen,5566,5718,11284,2011
42028,Zele,10416,10347,20763,2011
43000,Arrondissement d'Eeklo,41147,41311,82458,2011
43002,Assenede,6900,6967,13867,2011
43005,Eeklo,9909,10278,20187,2011
43007,Kaprijke,3128,3166,6294,2011
43010,Maldegem,11503,11494,22997,2011
43014,Sint-Laureins,3321,3214,6535,2011
43018,Zelzate,6386,6192,12578,2011
44000,Arrondissement de Gand,262675,270503,533178,2011
44001,Aalter,9837,9882,19719,2011
44011,Deinze,14460,15011,29471,2011
44012,De Pinte,4967,5314,10281,2011
44013,Destelbergen,8642,8994,17636,2011
44019,Evergem,16329,16911,33240,2011
44020,Gavere,6130,6321,12451,2011
44021,Gand,121876,125610,247486,2011
44029,Knesselare,4145,4040,8185,2011
44034,Lochristi,10719,10890,21609,2011
44036,Lovendegem,4640,4848,9488,2011
44040,Melle,5236,5637,10873,2011
44043,Merelbeke,11389,12002,23391,2011
44045,Moerbeke (Gand),3017,3020,6037,2011
44048,Nazareth,5520,5732,11252,2011
44049,Nevele,5917,6003,11920,2011
44052,Oosterzele,6645,6708,13353,2011
44064,Sint-Martens-Latem,4110,4268,8378,2011
44072,Waarschoot,3945,3981,7926,2011
44073,Wachtebeke,3563,3649,7212,2011
44080,Zomergem,3981,4177,8158,2011
44081,Zulte,7607,7505,15112,2011
45000,Arrondissement d'Audenarde,59364,61169,120533,2011
45017,Kruishoutem,4109,4031,8140,2011
45035,Audenarde,14754,15213,29967,2011
45041,Renaix,12316,12860,25176,2011
45057,Zingem,3556,3648,7204,2011
45059,Brakel,6908,7271,14179,2011
45060,Kluisbergen,3217,3261,6478,2011
45061,Wortegem-Petegem,3147,3126,6273,2011
45062,Horebeke,1008,1068,2076,2011
45063,Lierde,3199,3298,6497,2011
45064,Maarkedal,3156,3292,6448,2011
45065,Zwalm,3994,4101,8095,2011
46000,Arrondissement de Saint-Nicolas,117836,121261,239097,2011
46003,Beveren (Saint-Nicolas),23037,23481,46518,2011
46013,Kruibeke,7938,8008,15946,2011
46014,Lokeren,19539,20007,39546,2011
46020,Sint-Gillis-Waas,9283,9497,18780,2011
46021,Saint-Nicolas (Saint-Nicolas),35334,37032,72366,2011
46024,Stekene,8632,8807,17439,2011
46025,Tamise,14073,14429,28502,2011
50000,Province de Hainaut,636990,680294,1317284,2011
51000,Arrondissement d'Ath,41169,43324,84493,2011
51004,Ath,13692,14623,28315,2011
51008,Beloeil,6688,7065,13753,2011
51009,Bernissart,5683,6030,11713,2011
51012,Brugelette,1719,1750,3469,2011
51014,Chièvres,3256,3369,6625,2011
51017,Ellezelles,2858,3012,5870,2011
51019,Flobecq,1659,1751,3410,2011
51065,Frasnes-lez-Anvaing,5614,5724,11338,2011
52000,Arrondissement de Charleroi,206390,220868,427258,2011
52010,Chapelle-lez-Herlaimont,6870,7550,14420,2011
52011,Charleroi,98825,104639,203464,2011
52012,Châtelet,17209,18875,36084,2011
52015,Courcelles,14543,15813,30356,2011
52018,Farciennes,5323,5716,11039,2011
52021,Fleurus,10824,11656,22480,2011
52022,Fontaine-l'Evêque,8169,9000,17169,2011
52025,Gerpinnes,5873,6350,12223,2011
52043,Manage,11005,11440,22445,2011
52048,Montigny-le-Tilleul,4777,5347,10124,2011
52055,Pont-à-Celles,8105,8717,16822,2011
52063,Seneffe,5323,5580,10903,2011
52074,Aiseau-Presles,5115,5523,10638,2011
52075,Les Bons Villers,4429,4662,9091,2011
53000,Arrondissement de Mons,121141,132232,253373,2011
53014,Boussu,9421,10648,20069,2011
53020,Dour,8146,8797,16943,2011
53028,Frameries,9979,11159,21138,2011
53039,Hensies,3228,3548,6776,2011
53044,Jurbise,4792,5208,10000,2011
53046,Lens,2065,2185,4250,2011
53053,Mons,44404,48119,92523,2011
53065,Quaregnon,9044,9934,18978,2011
53068,Quiévrain,3193,3493,6686,2011
53070,Saint-Ghislain,10901,12072,22973,2011
53082,Colfontaine,9719,10465,20184,2011
53083,Honnelles,2491,2540,5031,2011
53084,Quévy,3758,4064,7822,2011
54000,Arrondissement de Mouscron,35353,37702,73055,2011
54007,Mouscron,26714,28535,55249,2011
54010,Comines-Warneton,8639,9167,17806,2011
55000,Arrondissement de Soignies,89103,95018,184121,2011
55004,Braine-le-Comte,10323,10941,21264,2011
55010,Enghien,6318,6685,13003,2011
55022,La Louvière,37748,40398,78146,2011
55023,Lessines,8916,9483,18399,2011
55035,Le Roeulx,4031,4238,8269,2011
55039,Silly,4060,4095,8155,2011
55040,Soignies,12539,13719,26258,2011
55050,Ecaussinnes,5168,5459,10627,2011
56000,Arrondissement de Thuin,72765,77036,149801,2011
56001,Anderlues,5652,6090,11742,2011
56005,Beaumont,3453,3597,7050,2011
56011,Binche,15697,17232,32929,2011
56016,Chimay,4817,5009,9826,2011
56022,Erquelinnes,4748,4982,9730,2011
56029,Froidchapelle,1901,1870,3771,2011
56044,Lobbes,2767,2907,5674,2011
56049,Merbes-le-Château,2122,2110,4232,2011
56051,Momignies,2608,2665,5273,2011
56078,Thuin,7160,7453,14613,2011
56085,Estinnes,3776,3908,7684,2011
56086,Ham-sur-Heure-Nalinnes,6486,6890,13376,2011
56087,Morlanwelz,9149,9880,19029,2011
56088,Sivry-Rance,2429,2443,4872,2011
57000,Arrondissement de Tournai,71069,74114,145183,2011
57003,Antoing,3732,3924,7656,2011
57018,Celles (Tournai),2743,2748,5491,2011
57027,Estaimpuis,4913,5115,10028,2011
57062,Pecq,2688,2772,5460,2011
57064,Péruwelz,8307,8760,17067,2011
57072,Rumes,2518,2611,5129,2011
57081,Tournai,33948,35492,69440,2011
57093,Brunehaut,3875,3984,7859,2011
57094,Leuze-en-Hainaut,6577,6948,13525,2011
57095,Mont-de-l'Enclus,1768,1760,3528,2011
60000,Province de Liège,524594,552609,1077203,2011
61000,Arrondissement de Huy,53387,55573,108960,2011
61003,Amay,6672,7054,13726,2011
61010,Burdinne,1499,1493,2992,2011
61012,Clavier,2183,2249,4432,2011
61019,Ferrières,2347,2356,4703,2011
61024,Hamoir,1864,1928,3792,2011
61028,Héron,2410,2528,4938,2011
61031,Huy,10206,10906,21112,2011
61039,Marchin,2608,2615,5223,2011
61041,Modave,1961,1985,3946,2011
61043,Nandrin,2801,2938,5739,2011
61048,Ouffet,1362,1352,2714,2011
61063,Verlaine,1888,1912,3800,2011
61068,Villers-Le-Bouillet,3122,3203,6325,2011
61072,Wanze,6366,6745,13111,2011
61079,Anthisnes,2026,2048,4074,2011
61080,Engis,2804,2955,5759,2011
61081,Tinlot,1268,1306,2574,2011
62000,Arrondissement de Liège,295082,314310,609392,2011
62003,Ans,13114,14520,27634,2011
62006,Awans,4222,4627,8849,2011
62009,Aywaille,5720,5870,11590,2011
62011,Bassenge,4281,4430,8711,2011
62015,Beyne-Heusay,5777,6243,12020,2011
62022,Chaudfontaine,9971,10971,20942,2011
62026,Comblain-au-Pont,2591,2803,5394,2011
62027,Dalhem,3401,3490,6891,2011
62032,Esneux,6353,6805,13158,2011
62038,Fléron,7644,8593,16237,2011
62051,Herstal,18405,19950,38355,2011
62060,Juprelle,4543,4468,9011,2011
62063,Liège,95702,99013,194715,2011
62079,Oupeye,11561,12593,24154,2011
62093,Saint-Nicolas (Liège),10941,12230,23171,2011
62096,Seraing,30170,32972,63142,2011
62099,Soumagne,7960,8275,16235,2011
62100,Sprimont,6674,7061,13735,2011
62108,Visé,8204,8907,17111,2011
62118,Grâce-Hollogne,10613,11315,21928,2011
62119,Blégny,6509,6681,13190,2011
62120,Flémalle,12027,13308,25335,2011
62121,Neupré,4744,5101,9845,2011
62122,Trooz,3955,4084,8039,2011
63000,Arrondissement de Verviers,138774,143519,282293,2011
63001,Amblève,2781,2654,5435,2011
63003,Aubel,2047,2120,4167,2011
63004,Baelen,2117,2131,4248,2011
63012,Bullange,2825,2712,5537,2011
63013,Butgenbach,2862,2852,5714,2011
63020,Dison,7378,7671,15049,2011
63023,Eupen,9216,9662,18878,2011
63035,Herve,8303,8813,17116,2011
63038,Jalhay,4145,4157,8302,2011
63040,La Calamine,5389,5492,10881,2011
63045,Lierneux,1760,1722,3482,2011
63046,Limbourg,2876,2889,5765,2011
63048,Lontzen,2726,2740,5466,2011
63049,Malmedy,5867,6352,12219,2011
63057,Olne,1908,1905,3813,2011
63058,Pepinster,4745,4969,9714,2011
63061,Raeren,5139,5317,10456,2011
63067,Saint-Vith,4707,4670,9377,2011
63072,Spa,5059,5470,10529,2011
63073,Stavelot,3432,3435,6867,2011
63075,Stoumont,1518,1527,3045,2011
63076,Theux,5857,6138,11995,2011
63079,Verviers,26969,28770,55739,2011
63080,Waimes,3550,3504,7054,2011
63084,Welkenraedt,4716,4922,9638,2011
63086,Trois-Ponts,1235,1271,2506,2011
63087,Burg-Reuland,2005,1967,3972,2011
63088,Plombières,4918,4961,9879,2011
63089,Thimister-Clermont,2724,2726,5450,2011
64000,Arrondissement de Waremme,37351,39207,76558,2011
64008,Berloz,1436,1501,2937,2011
64015,Braives,2895,2957,5852,2011
64021,Crisnée,1465,1561,3026,2011
64023,Donceel,1491,1440,2931,2011
64025,Fexhe-le-Haut-Clocher,1582,1601,3183,2011
64029,Geer,1577,1614,3191,2011
64034,Hannut,7447,7954,15401,2011
64047,Lincent,1562,1645,3207,2011
64056,Oreye,1715,1848,3563,2011
64063,Remicourt,2715,2863,5578,2011
64065,Saint-Georges-sur-Meuse,3188,3307,6495,2011
64074,Waremme,7071,7666,14737,2011
64075,Wasseiges,1326,1368,2694,2011
64076,Faimes,1881,1882,3763,2011
70000,Province de Limbourg,421048,423573,844621,2011
71000,Arrondissement de Hasselt,204187,207461,411648,2011
71002,As,3955,3901,7856,2011
71004,Beringen,21599,21604,43203,2011
71011,Diepenbeek,9183,9059,18242,2011
71016,Genk,31970,33017,64987,2011
71017,Gingelom,4089,4125,8214,2011
71020,Halen,4600,4642,9242,2011
71022,Hasselt,36145,37662,73807,2011
71024,Herck-la-Ville,6074,6190,12264,2011
71034,Bourg-Léopold,7528,7542,15070,2011
71037,Lummen,7217,7105,14322,2011
71045,Nieuwerkerken (Hasselt),3341,3346,6687,2011
71047,Opglabbeek,5098,5022,10120,2011
71053,Saint-Trond,19540,20039,39579,2011
71057,Tessenderlo,8895,9047,17942,2011
71066,Zonhoven,10342,10474,20816,2011
71067,Zutendaal,3543,3504,7047,2011
71069,Ham,5177,5198,10375,2011
71070,Heusden-Zolder,15891,15984,31875,2011
72000,Arrondissement de Maaseik,117849,116328,234177,2011
72003,Bocholt,6331,6362,12693,2011
72004,Bree,7601,7637,15238,2011
72018,Kinrooi,6290,5989,12279,2011
72020,Lommel,16610,16583,33193,2011
72021,Maaseik,12381,12343,24724,2011
72025,Neerpelt,8314,8269,16583,2011
72029,Overpelt,7212,7013,14225,2011
72030,Peer,8188,7980,16168,2011
72037,Hamont-Achel,7175,7005,14180,2011
72038,Hechtel-Eksel,6005,5842,11847,2011
72039,Houthalen-Helchteren,15200,15118,30318,2011
72040,Meeuwen-Gruitrode,6590,6302,12892,2011
72041,Dilsen-Stokkem,9952,9885,19837,2011
73000,Arrondissement de Tongres,99012,99784,198796,2011
73001,Alken,5678,5599,11277,2011
73006,Bilzen,15494,15732,31226,2011
73009,Looz,5193,5257,10450,2011
73022,Heers,3511,3579,7090,2011
73028,Herstappe,47,38,85,2011
73032,Hoeselt,4776,4826,9602,2011
73040,Kortessem,4169,4153,8322,2011
73042,Lanaken,12898,12594,25492,2011
73066,Riemst,8107,8103,16210,2011
73083,Tongres,14867,15434,30301,2011
73098,Wellen,3697,3686,7383,2011
73107,Maasmechelen,18458,18719,37177,2011
73109,Fourons,2117,2064,4181,2011
80000,Province de Luxembourg,134501,136851,271352,2011
81000,Arrondissement d'Arlon,29021,29442,58463,2011
81001,Arlon,13927,14059,27986,2011
81003,Attert,2546,2576,5122,2011
81004,Aubange,7786,8049,15835,2011
81013,Martelange,847,835,1682,2011
81015,Messancy,3915,3923,7838,2011
82000,Arrondissement de Bastogne,22661,22792,45453,2011
82003,Bastogne,7442,7609,15051,2011
82005,Bertogne,1600,1576,3176,2011
82009,Fauvillers,1096,1134,2230,2011
82014,Houffalize,2535,2473,5008,2011
82032,Vielsalm,3750,3755,7505,2011
82036,Vaux-sur-Sûre,2573,2552,5125,2011
82037,Gouvy,2445,2486,4931,2011
82038,Sainte-Ode,1220,1207,2427,2011
83000,Arrondissement de Marche-en-Famenne,27254,27543,54797,2011
83012,Durbuy,5446,5626,11072,2011
83013,Erezée,1555,1508,3063,2011
83028,Hotton,2641,2667,5308,2011
83031,La Roche-en-Ardenne,2158,2146,4304,2011
83034,Marche-en-Famenne,8582,8813,17395,2011
83040,Nassogne,2637,2570,5207,2011
83044,Rendeux,1228,1231,2459,2011
83049,Tenneville,1336,1354,2690,2011
83055,Manhay,1671,1628,3299,2011
84000,Arrondissement de Neufchâteau,29836,30532,60368,2011
84009,Bertrix,4141,4272,8413,2011
84010,Bouillon,2654,2810,5464,2011
84016,Daverdisse,696,709,1405,2011
84029,Herbeumont,760,797,1557,2011
84033,Léglise,2396,2334,4730,2011
84035,Libin,2399,2451,4850,2011
84043,Neufchâteau (Neufchâteau),3510,3580,7090,2011
84050,Paliseul,2603,2604,5207,2011
84059,Saint-Hubert,2841,2859,5700,2011
84068,Tellin,1234,1259,2493,2011
84075,Wellin,1454,1546,3000,2011
84077,Libramont-Chevigny,5148,5311,10459,2011
85000,Arrondissement de Virton,25729,26542,52271,2011
85007,Chiny,2554,2593,5147,2011
85009,Etalle,2801,2795,5596,2011
85011,Florenville,2683,2800,5483,2011
85024,Meix-devant-Virton,1361,1377,2738,2011
85026,Musson,2145,2264,4409,2011
85034,Saint-Léger (Virton),1626,1664,3290,2011
85039,Tintigny,1932,1966,3898,2011
85045,Virton,5521,5897,11418,2011
85046,Habay,4099,4119,8218,2011
85047,Rouvroy,1007,1067,2074,2011
90000,Province de Namur,232632,244203,476835,2011
91000,Arrondissement de Dinant,52469,54630,107099,2011
91005,Anhée,3432,3600,7032,2011
91013,Beauraing,4251,4577,8828,2011
91015,Bièvre,1587,1584,3171,2011
91030,Ciney,7543,8169,15712,2011
91034,Dinant,6530,6990,13520,2011
91054,Gedinne,2171,2294,4465,2011
91059,Hamois,3497,3485,6982,2011
91064,Havelange,2496,2561,5057,2011
91072,Houyet,2243,2314,4557,2011
91103,Onhaye,1549,1575,3124,2011
91114,Rochefort,6077,6301,12378,2011
91120,Somme-Leuze,2472,2486,4958,2011
91141,Yvoir,4389,4492,8881,2011
91142,Hastière,2865,2793,5658,2011
91143,Vresse-sur-Semois,1367,1409,2776,2011
92000,Arrondissement de Namur,148180,156107,304287,2011
92003,Andenne,12454,13057,25511,2011
92006,Assesse,3298,3312,6610,2011
92035,Eghezée,7490,7777,15267,2011
92045,Floreffe,3816,3994,7810,2011
92048,Fosses-la-Ville,5005,4899,9904,2011
92054,Gesves,3344,3372,6716,2011
92087,Mettet,6225,6457,12682,2011
92094,Namur,52761,57004,109765,2011
92097,Ohey,2322,2375,4697,2011
92101,Profondeville,5647,5878,11525,2011
92114,Sombreffe,4005,4127,8132,2011
92137,Sambreville,13153,14325,27478,2011
92138,Fernelmont,3536,3606,7142,2011
92140,Jemeppe-sur-Sambre,9040,9450,18490,2011
92141,La Bruyère,4330,4523,8853,2011
92142,Gembloux,11754,11951,23705,2011
93000,Arrondissement de Philippeville,31983,33466,65449,2011
93010,Cerfontaine,2407,2413,4820,2011
93014,Couvin,6665,7103,13768,2011
93018,Doische,1413,1472,2885,2011
93022,Florennes,5480,5668,11148,2011
93056,Philippeville,4445,4520,8965,2011
93088,Walcourt,8802,9290,18092,2011
93090,Viroinval,2771,3000,5771,2011
