code_ins,lieu_de_residence,hommes,femmes,total,annee
01000,Belgique,4958662,5184114,10142776,1996
02000,Région flamande,2902083,2978185,5880268,1996
03000,Région wallonne,1606456,1707965,3314421,1996
04000,Région de Bruxelles-Capitale,450123,497964,948087,1996
10000,Province d'Anvers,804339,826852,1631191,1996
11000,Arrondissement d'Anvers,455991,476998,932989,1996
11001,Aartselaar,7132,7258,14390,1996
11002,Anvers,220304,235548,455852,1996
11004,Boechout,5837,5822,11659,1996
11005,Boom,7087,7502,14589,1996
11007,Borsbeek,5014,5268,10282,1996
11008,Brasschaat,18153,18721,36874,1996
11009,Brecht,11898,11699,23597,1996
11013,Edegem,11182,11618,22800,1996
11016,Essen,7810,7816,15626,1996
11018,Hemiksem,4547,4689,9236,1996
11021,Hove (Anvers),4002,4265,8267,1996
11022,Kalmthout,8416,8495,16911,1996
11023,Kapellen (Anvers),12413,12943,25356,1996
11024,Kontich,9636,9807,19443,1996
11025,Lint,3763,3824,7587,1996
11029,Mortsel,12385,13226,25611,1996
11030,Niel,3893,4084,7977,1996
11035,Ranst,8663,8548,17211,1996
11037,Rumst,7255,7254,14509,1996
11038,Schelle,3713,3793,7506,1996
11039,Schilde,9602,9784,19386,1996
11040,Schoten,15564,16348,31912,1996
11044,Stabroek,8368,8405,16773,1996
11050,Wijnegem,4115,4428,8543,1996
11052,Wommelgem,5607,5837,11444,1996
11053,Wuustwezel,8523,8329,16852,1996
11054,Zandhoven,5852,5749,11601,1996
11055,Zoersel,9695,10088,19783,1996
11056,Zwijndrecht,8865,9108,17973,1996
11057,Malle,6697,6742,13439,1996
12000,Arrondissement de Malines,148347,152713,301060,1996
12002,Berlaar,4869,4996,9865,1996
12005,Bonheiden,6510,6894,13404,1996
12007,Bornem,9720,9805,19525,1996
12009,Duffel,7514,8075,15589,1996
12014,Heist-op-den-Berg,18464,18297,36761,1996
12021,Lierre,15394,16229,31623,1996
12025,Malines,36656,38638,75294,1996
12026,Nijlen,10121,9976,20097,1996
12029,Putte,7502,7490,14992,1996
12030,Puurs,7694,7715,15409,1996
12034,Sint-Amands,3713,3705,7418,1996
12035,Sint-Katelijne-Waver,9267,9476,18743,1996
12040,Willebroek,10923,11417,22340,1996
13000,Arrondissement de Turnhout,200001,197141,397142,1996
13001,Arendonk,5787,5697,11484,1996
13002,Baerle-Duc,1063,1039,2102,1996
13003,Balen,9585,9324,18909,1996
13004,Beerse,7552,7431,14983,1996
13006,Dessel,4269,4098,8367,1996
13008,Geel,16691,16622,33313,1996
13010,Grobbendonk,5229,5115,10344,1996
13011,Herentals,12473,12655,25128,1996
13012,Herenthout,4125,4027,8152,1996
13013,Herselt,6734,6383,13117,1996
13014,Hoogstraten,8590,8203,16793,1996
13016,Hulshout,4064,4037,8101,1996
13017,Kasterlee,8795,8444,17239,1996
13019,Lille,7386,7114,14500,1996
13021,Meerhout,4654,4595,9249,1996
13023,Merksplas,3997,3859,7856,1996
13025,Mol,15500,15503,31003,1996
13029,Olen,5343,5352,10695,1996
13031,Oud-Turnhout,6133,6163,12296,1996
13035,Ravels,6379,6141,12520,1996
13036,Retie,4856,4641,9497,1996
13037,Rijkevorsel,5156,4936,10092,1996
13040,Turnhout,18947,19520,38467,1996
13044,Vorselaar,3533,3657,7190,1996
13046,Vosselaar,4880,4786,9666,1996
13049,Westerlo,10850,10611,21461,1996
13053,Laakdal,7430,7188,14618,1996
20001,Province du Brabant flamand,490334,508851,999185,1996
20002,Province du Brabant wallon,165279,173779,339058,1996
21000,Arrondissement de Bruxelles-Capitale,450123,497964,948087,1996
21001,Anderlecht,41865,45392,87257,1996
21002,Auderghem,13571,15555,29126,1996
21003,Berchem-Sainte-Agathe,8475,9876,18351,1996
21004,Bruxelles,65502,67601,133103,1996
21005,Etterbeek,17693,20707,38400,1996
21006,Evere,13662,15982,29644,1996
21007,Forest (Bruxelles-Capitale),21362,24150,45512,1996
21008,Ganshoren,8942,10970,19912,1996
21009,Ixelles,34866,37492,72358,1996
21010,Jette,17634,20845,38479,1996
21011,Koekelberg,7525,8391,15916,1996
21012,Molenbeek-Saint-Jean,33142,35371,68513,1996
21013,Saint-Gilles,21382,21480,42862,1996
21014,Saint-Josse-ten-Noode,10787,10853,21640,1996
21015,Schaerbeek,50118,53304,103422,1996
21016,Uccle,33747,40174,73921,1996
21017,Watermael-Boitsfort,11347,13417,24764,1996
21018,Woluwe-Saint-Lambert,20950,25846,46796,1996
21019,Woluwe-Saint-Pierre,17553,20558,38111,1996
23000,Arrondissement de Hal-Vilvorde,268832,281674,550506,1996
23002,Asse,13374,14127,27501,1996
23003,Beersel,11116,11594,22710,1996
23009,Biévène,925,968,1893,1996
23016,Dilbeek,18196,19156,37352,1996
23023,Gammerages,3719,3812,7531,1996
23024,Gooik,4262,4249,8511,1996
23025,Grimbergen,15802,16935,32737,1996
23027,Hal (Hal-Vilvorde),16276,17110,33386,1996
23032,Herne,3130,3186,6316,1996
23033,Hoeilaart,4691,4939,9630,1996
23038,Kampenhout,5176,5339,10515,1996
23039,Kapelle-op-den-Bos,4461,4460,8921,1996
23044,Liedekerke,5787,5887,11674,1996
23045,Londerzeel,8535,8676,17211,1996
23047,Machelen (Hal-Vilvorde),5581,5937,11518,1996
23050,Meise,8776,9086,17862,1996
23052,Merchtem,6883,6943,13826,1996
23060,Opwijk,5707,5868,11575,1996
23062,Overijse,11454,12137,23591,1996
23064,Pepingen,2049,2067,4116,1996
23077,Sint-Pieters-Leeuw,14418,15225,29643,1996
23081,Steenokkerzeel,4966,5164,10130,1996
23086,Ternat,7022,7101,14123,1996
23088,Vilvorde,16111,17372,33483,1996
23094,Zaventem,12855,13612,26467,1996
23096,Zemst,9813,10144,19957,1996
23097,Roosdaal,5118,5277,10395,1996
23098,Drogenbos,2196,2470,4666,1996
23099,Kraainem,6276,6639,12915,1996
23100,Linkebeek,2271,2376,4647,1996
23101,Rhode-Saint-Genèse,8835,9264,18099,1996
23102,Wemmel,6542,7196,13738,1996
23103,Wezembeek-Oppem,6550,7073,13623,1996
23104,Lennik,4127,4306,8433,1996
23105,Affligem,5832,5979,11811,1996
24000,Arrondissement de Louvain,221502,227177,448679,1996
24001,Aarschot,13474,13644,27118,1996
24007,Begijnendijk,4418,4479,8897,1996
24008,Bekkevoort,2762,2718,5480,1996
24009,Bertem,4294,4471,8765,1996
24011,Bierbeek,4388,4398,8786,1996
24014,Boortmeerbeek,5696,5654,11350,1996
24016,Boutersem,3529,3450,6979,1996
24020,Diest,10820,11005,21825,1996
24028,Geetbets,2834,2845,5679,1996
24033,Haacht,6299,6492,12791,1996
24038,Herent,9093,9383,18476,1996
24041,Hoegaarden,2864,3004,5868,1996
24043,Holsbeek,4205,4153,8358,1996
24045,Huldenberg,4179,4458,8637,1996
24048,Keerbergen,5751,5791,11542,1996
24054,Kortenaken,3749,3698,7447,1996
24055,Kortenberg,8252,8566,16818,1996
24059,Landen,6952,7310,14262,1996
24062,Louvain,42420,44712,87132,1996
24066,Lubbeek,6578,6617,13195,1996
24086,Oud-Heverlee,5216,5220,10436,1996
24094,Rotselaar,7116,7077,14193,1996
24104,Tervuren,9794,10195,19989,1996
24107,Tirlemont,15298,16336,31634,1996
24109,Tremelo,6382,6225,12607,1996
24130,Léau,3828,3848,7676,1996
24133,Linter,3378,3408,6786,1996
24134,Montaigu-Zichem,10611,10770,21381,1996
24135,Tielt-Winge,4807,4830,9637,1996
24137,Glabbeek,2515,2420,4935,1996
25000,Arrondissement de Nivelles,165279,173779,339058,1996
25005,Beauvechain,3077,3058,6135,1996
25014,Braine-l'Alleud,16538,17652,34190,1996
25015,Braine-le-Château,4226,4349,8575,1996
25018,Chaumont-Gistoux,4709,4762,9471,1996
25023,Court-Saint-Etienne,4071,4193,8264,1996
25031,Genappe,6683,6812,13495,1996
25037,Grez-Doiceau,5491,5772,11263,1996
25043,Incourt,1886,1922,3808,1996
25044,Ittre,2655,2805,5460,1996
25048,Jodoigne,5329,5713,11042,1996
25050,La Hulpe,3344,3571,6915,1996
25068,Mont-Saint-Guibert,2784,2757,5541,1996
25072,Nivelles,11297,12365,23662,1996
25084,Perwez (Nivelles),3322,3456,6778,1996
25091,Rixensart,10298,11007,21305,1996
25105,Tubize,10394,10874,21268,1996
25107,Villers-la-Ville,4374,4447,8821,1996
25110,Waterloo,13563,14783,28346,1996
25112,Wavre,14346,15560,29906,1996
25117,Chastre,2985,3179,6164,1996
25118,Hélécine,1390,1423,2813,1996
25119,Lasne,6612,6769,13381,1996
25120,Orp-Jauche,3447,3669,7116,1996
25121,Ottignies-Louvain-la-Neuve,12754,12869,25623,1996
25122,Ramillies,2472,2522,4994,1996
25123,Rebecq,4641,4918,9559,1996
25124,Walhain,2591,2572,5163,1996
30000,Province de Flandre occidentale,553783,569066,1122849,1996
31000,Arrondissement de Bruges,131443,136578,268021,1996
31003,Beernem,7391,6947,14338,1996
31004,Blankenberge,8297,8969,17266,1996
31005,Bruges,56102,59713,115815,1996
31006,Damme,5439,5441,10880,1996
31012,Jabbeke,6663,6619,13282,1996
31022,Oostkamp,10464,10544,21008,1996
31033,Torhout,9322,9371,18693,1996
31040,Zedelgem,10690,10691,21381,1996
31042,Zuienkerke,1424,1342,2766,1996
31043,Knokke-Heist,15651,16941,32592,1996
32000,Arrondissement de Dixmude,23895,23774,47669,1996
32003,Dixmude,7613,7632,15245,1996
32006,Houthulst,4429,4481,8910,1996
32010,Koekelare,4057,3973,8030,1996
32011,Kortemark,6191,6112,12303,1996
32030,Lo-Reninge,1605,1576,3181,1996
33000,Arrondissement d'Ypres,51698,52644,104342,1996
33011,Ypres,17258,18141,35399,1996
33016,Messines,512,480,992,1996
33021,Poperinge,9508,9676,19184,1996
33029,Wervik,8815,9016,17831,1996
33037,Zonnebeke,5713,5637,11350,1996
33039,Heuvelland,4307,4142,8449,1996
33040,Langemark-Poelkapelle,3772,3752,7524,1996
33041,Vleteren,1813,1800,3613,1996
34000,Arrondissement de Courtrai,137957,141082,279039,1996
34002,Anzegem,6749,6700,13449,1996
34003,Avelgem,4471,4642,9113,1996
34009,Deerlijk,5667,5753,11420,1996
34013,Harelbeke,13151,13190,26341,1996
34022,Courtrai,37209,38742,75951,1996
34023,Kuurne,6470,6491,12961,1996
34025,Lendelede,2745,2742,5487,1996
34027,Menin,15776,16612,32388,1996
34040,Waregem,17735,17990,35725,1996
34041,Wevelgem,15464,15592,31056,1996
34042,Zwevegem,11578,11683,23261,1996
34043,Espierres-Helchin,942,945,1887,1996
35000,Arrondissement d'Ostende,68728,72425,141153,1996
35002,Bredene,6458,6562,13020,1996
35005,Gistel,5184,5343,10527,1996
35006,Ichtegem,6669,6526,13195,1996
35011,Middelkerke,7863,8117,15980,1996
35013,Ostende,32816,35819,68635,1996
35014,Oudenburg,4279,4318,8597,1996
35029,De Haan,5459,5740,11199,1996
36000,Arrondissement de Roulers,69352,70260,139612,1996
36006,Hooglede,4835,4720,9555,1996
36007,Ingelmunster,5284,5427,10711,1996
36008,Izegem,13039,13453,26492,1996
36010,Ledegem,4709,4647,9356,1996
36011,Lichtervelde,4074,4082,8156,1996
36012,Moorslede,5403,5336,10739,1996
36015,Roulers,26537,27169,53706,1996
36019,Staden,5471,5426,10897,1996
37000,Arrondissement de Tielt,43594,43818,87412,1996
37002,Dentergem,3799,3874,7673,1996
37007,Meulebeke,5421,5495,10916,1996
37010,Oostrozebeke,3596,3603,7199,1996
37011,Pittem,3284,3288,6572,1996
37012,Ruiselede,2552,2564,5116,1996
37015,Tielt (Tielt),9597,9838,19435,1996
37017,Wielsbeke,4283,4295,8578,1996
37018,Wingene,6188,6100,12288,1996
37020,Ardooie,4874,4761,9635,1996
38000,Arrondissement de Furnes,27116,28485,55601,1996
38002,Alveringem,2434,2306,4740,1996
38008,La Panne,4719,5239,9958,1996
38014,Koksijde,9412,9803,19215,1996
38016,Nieuport,4964,5205,10169,1996
38025,Furnes,5587,5932,11519,1996
40000,Province de Flandre orientale,665260,686481,1351741,1996
41000,Arrondissement d'Alost,128427,132450,260877,1996
41002,Alost (Alost),37331,38848,76179,1996
41011,Denderleeuw,8348,8616,16964,1996
41018,Grammont,15112,15568,30680,1996
41024,Haaltert,8539,8633,17172,1996
41027,Herzele,8007,8077,16084,1996
41034,Lede,8300,8663,16963,1996
41048,Ninove,16928,17261,34189,1996
41063,Sint-Lievens-Houtem,4460,4617,9077,1996
41081,Zottegem,11908,12555,24463,1996
41082,Erpe-Mere,9494,9612,19106,1996
42000,Arrondissement de Termonde,91632,93458,185090,1996
42003,Berlare,6594,6676,13270,1996
42004,Buggenhout,6824,6856,13680,1996
42006,Termonde,20996,21851,42847,1996
42008,Hamme (Termonde),11380,11320,22700,1996
42010,Laarne,5788,5832,11620,1996
42011,Lebbeke,8469,8505,16974,1996
42023,Waasmunster,4947,4952,9899,1996
42025,Wetteren,11017,11748,22765,1996
42026,Wichelen,5372,5521,10893,1996
42028,Zele,10245,10197,20442,1996
43000,Arrondissement d'Eeklo,39682,39792,79474,1996
43002,Assenede,6767,6818,13585,1996
43005,Eeklo,9366,9735,19101,1996
43007,Kaprijke,3085,3051,6136,1996
43010,Maldegem,10990,10874,21864,1996
43014,Sint-Laureins,3334,3222,6556,1996
43018,Zelzate,6140,6092,12232,1996
44000,Arrondissement de Gand,240509,251232,491741,1996
44001,Aalter,8783,8821,17604,1996
44011,Deinze,13206,13651,26857,1996
44012,De Pinte,4968,5107,10075,1996
44013,Destelbergen,8586,8759,17345,1996
44019,Evergem,14971,15256,30227,1996
44020,Gavere,5677,5789,11466,1996
44021,Gand,109555,116909,226464,1996
44029,Knesselare,3951,3908,7859,1996
44034,Lochristi,9009,9008,18017,1996
44036,Lovendegem,4492,4666,9158,1996
44040,Melle,4799,5302,10101,1996
44043,Merelbeke,10229,10798,21027,1996
44045,Moerbeke (Gand),2871,2895,5766,1996
44048,Nazareth,5241,5382,10623,1996
44049,Nevele,5307,5475,10782,1996
44052,Oosterzele,6445,6651,13096,1996
44064,Sint-Martens-Latem,3993,4210,8203,1996
44072,Waarschoot,3921,3993,7914,1996
44073,Wachtebeke,3398,3524,6922,1996
44080,Zomergem,4034,4117,8151,1996
44081,Zulte,7073,7011,14084,1996
45000,Arrondissement d'Audenarde,55825,57821,113646,1996
45017,Kruishoutem,3919,3799,7718,1996
45035,Audenarde,13341,13973,27314,1996
45041,Renaix,11739,12521,24260,1996
45057,Zingem,3206,3286,6492,1996
45059,Brakel,6670,7044,13714,1996
45060,Kluisbergen,2985,3065,6050,1996
45061,Wortegem-Petegem,3011,2999,6010,1996
45062,Horebeke,945,979,1924,1996
45063,Lierde,3099,3096,6195,1996
45064,Maarkedal,3094,3248,6342,1996
45065,Zwalm,3816,3811,7627,1996
46000,Arrondissement de Saint-Nicolas,109185,111728,220913,1996
46003,Beveren (Saint-Nicolas),22020,22159,44179,1996
46013,Kruibeke,7217,7191,14408,1996
46014,Lokeren,17566,18219,35785,1996
46020,Sint-Gillis-Waas,8399,8474,16873,1996
46021,Saint-Nicolas (Saint-Nicolas),33271,34863,68134,1996
46024,Stekene,8292,8331,16623,1996
46025,Tamise,12420,12491,24911,1996
50000,Province de Hainaut,619520,665161,1284681,1996
51000,Arrondissement d'Ath,38097,40020,78117,1996
51004,Ath,12135,12819,24954,1996
51008,Beloeil,6466,6676,13142,1996
51009,Bernissart,5564,5875,11439,1996
51012,Brugelette,1587,1705,3292,1996
51014,Chièvres,2855,3026,5881,1996
51017,Ellezelles,2711,2814,5525,1996
51019,Flobecq,1463,1646,3109,1996
51065,Frasnes-lez-Anvaing,5316,5459,10775,1996
52000,Arrondissement de Charleroi,204818,221649,426467,1996
52010,Chapelle-lez-Herlaimont,6709,7382,14091,1996
52011,Charleroi,98520,107011,205531,1996
52012,Châtelet,17156,18858,36014,1996
52015,Courcelles,14293,15307,29600,1996
52018,Farciennes,5631,6075,11706,1996
52021,Fleurus,10806,11731,22537,1996
52022,Fontaine-l'Evêque,8242,9008,17250,1996
52025,Gerpinnes,5638,6100,11738,1996
52043,Manage,10646,11280,21926,1996
52048,Montigny-le-Tilleul,4864,5368,10232,1996
52055,Pont-à-Celles,7715,8112,15827,1996
52063,Seneffe,5158,5411,10569,1996
52074,Aiseau-Presles,5323,5657,10980,1996
52075,Les Bons Villers,4117,4349,8466,1996
53000,Arrondissement de Mons,120344,131792,252136,1996
53014,Boussu,9768,10730,20498,1996
53020,Dour,8175,8900,17075,1996
53028,Frameries,9949,11101,21050,1996
53039,Hensies,3306,3394,6700,1996
53044,Jurbise,4263,4580,8843,1996
53046,Lens,1854,1933,3787,1996
53053,Mons,43670,48586,92256,1996
53065,Quaregnon,9329,10066,19395,1996
53068,Quiévrain,3351,3549,6900,1996
53070,Saint-Ghislain,10489,11604,22093,1996
53082,Colfontaine,10128,11016,21144,1996
53083,Honnelles,2451,2544,4995,1996
53084,Quévy,3611,3789,7400,1996
54000,Arrondissement de Mouscron,34197,36295,70492,1996
54007,Mouscron,25517,27239,52756,1996
54010,Comines-Warneton,8680,9056,17736,1996
55000,Arrondissement de Soignies,82926,88194,171120,1996
55004,Braine-le-Comte,8889,9379,18268,1996
55010,Enghien,5160,5411,10571,1996
55022,La Louvière,37062,39652,76714,1996
55023,Lessines,8043,8550,16593,1996
55035,Le Roeulx,3845,4012,7857,1996
55039,Silly,3563,3586,7149,1996
55040,Soignies,11684,12683,24367,1996
55050,Ecaussinnes,4680,4921,9601,1996
56000,Arrondissement de Thuin,70645,74739,145384,1996
56001,Anderlues,5506,5971,11477,1996
56005,Beaumont,3102,3291,6393,1996
56011,Binche,15636,16863,32499,1996
56016,Chimay,4727,5017,9744,1996
56022,Erquelinnes,4687,5008,9695,1996
56029,Froidchapelle,1524,1570,3094,1996
56044,Lobbes,2705,2742,5447,1996
56049,Merbes-le-Château,1986,2043,4029,1996
56051,Momignies,2542,2569,5111,1996
56078,Thuin,7083,7427,14510,1996
56085,Estinnes,3664,3795,7459,1996
56086,Ham-sur-Heure-Nalinnes,6333,6652,12985,1996
56087,Morlanwelz,8877,9488,18365,1996
56088,Sivry-Rance,2273,2303,4576,1996
57000,Arrondissement de Tournai,68493,72472,140965,1996
57003,Antoing,3701,3926,7627,1996
57018,Celles (Tournai),2644,2750,5394,1996
57027,Estaimpuis,4661,4867,9528,1996
57062,Pecq,2522,2611,5133,1996
57064,Péruwelz,8072,8550,16622,1996
57072,Rumes,2499,2602,5101,1996
57081,Tournai,32861,35065,67926,1996
57093,Brunehaut,3674,3849,7523,1996
57094,Leuze-en-Hainaut,6336,6703,13039,1996
57095,Mont-de-l'Enclus,1523,1549,3072,1996
60000,Province de Liège,490857,522810,1013667,1996
61000,Arrondissement de Huy,47402,49620,97022,1996
61003,Amay,6218,6616,12834,1996
61010,Burdinne,1273,1251,2524,1996
61012,Clavier,1956,2002,3958,1996
61019,Ferrières,1978,2051,4029,1996
61024,Hamoir,1674,1760,3434,1996
61028,Héron,1978,2092,4070,1996
61031,Huy,8815,9629,18444,1996
61039,Marchin,2439,2476,4915,1996
61041,Modave,1735,1739,3474,1996
61043,Nandrin,2479,2544,5023,1996
61048,Ouffet,1243,1225,2468,1996
61063,Verlaine,1622,1635,3257,1996
61068,Villers-Le-Bouillet,2585,2682,5267,1996
61072,Wanze,5746,6110,11856,1996
61079,Anthisnes,1867,1887,3754,1996
61080,Engis,2778,2845,5623,1996
61081,Tinlot,1016,1076,2092,1996
62000,Arrondissement de Liège,283427,306460,589887,1996
62003,Ans,13108,14492,27600,1996
62006,Awans,3892,4270,8162,1996
62009,Aywaille,4772,4951,9723,1996
62011,Bassenge,4003,4093,8096,1996
62015,Beyne-Heusay,5538,5945,11483,1996
62022,Chaudfontaine,10004,10745,20749,1996
62026,Comblain-au-Pont,2527,2705,5232,1996
62027,Dalhem,2991,3022,6013,1996
62032,Esneux,6321,6740,13061,1996
62038,Fléron,7530,8352,15882,1996
62051,Herstal,17356,19209,36565,1996
62060,Juprelle,3954,4102,8056,1996
62063,Liège,91175,99350,190525,1996
62079,Oupeye,11380,12291,23671,1996
62093,Saint-Nicolas (Liège),11165,12237,23402,1996
62096,Seraing,29037,32014,61051,1996
62099,Soumagne,7015,7187,14202,1996
62100,Sprimont,5791,6056,11847,1996
62108,Visé,8066,8595,16661,1996
62118,Grâce-Hollogne,10897,11566,22463,1996
62119,Blégny,5933,6043,11976,1996
62120,Flémalle,12591,13842,26433,1996
62121,Neupré,4615,4762,9377,1996
62122,Trooz,3766,3891,7657,1996
63000,Arrondissement de Verviers,128043,132941,260984,1996
63001,Amblève,2514,2383,4897,1996
63003,Aubel,1867,1894,3761,1996
63004,Baelen,1809,1829,3638,1996
63012,Bullange,2652,2563,5215,1996
63013,Butgenbach,2699,2650,5349,1996
63020,Dison,6881,7159,14040,1996
63023,Eupen,8320,8951,17271,1996
63035,Herve,7950,8232,16182,1996
63038,Jalhay,3493,3503,6996,1996
63040,La Calamine,4862,4937,9799,1996
63045,Lierneux,1684,1594,3278,1996
63046,Limbourg,2662,2710,5372,1996
63048,Lontzen,2380,2387,4767,1996
63049,Malmedy,5176,5563,10739,1996
63057,Olne,1784,1814,3598,1996
63058,Pepinster,4417,4663,9080,1996
63061,Raeren,4705,4775,9480,1996
63067,Saint-Vith,4394,4486,8880,1996
63072,Spa,4890,5475,10365,1996
63073,Stavelot,3200,3273,6473,1996
63075,Stoumont,1381,1420,2801,1996
63076,Theux,5245,5384,10629,1996
63079,Verviers,25793,27761,53554,1996
63080,Waimes,3143,3157,6300,1996
63084,Welkenraedt,4247,4404,8651,1996
63086,Trois-Ponts,1090,1179,2269,1996
63087,Burg-Reuland,1921,1841,3762,1996
63088,Plombières,4518,4582,9100,1996
63089,Thimister-Clermont,2366,2372,4738,1996
64000,Arrondissement de Waremme,31985,33789,65774,1996
64008,Berloz,1202,1250,2452,1996
64015,Braives,2530,2672,5202,1996
64021,Crisnée,1172,1228,2400,1996
64023,Donceel,1241,1251,2492,1996
64025,Fexhe-le-Haut-Clocher,1372,1462,2834,1996
64029,Geer,1193,1246,2439,1996
64034,Hannut,6084,6535,12619,1996
64047,Lincent,1347,1413,2760,1996
64056,Oreye,1525,1597,3122,1996
64063,Remicourt,2226,2373,4599,1996
64065,Saint-Georges-sur-Meuse,3323,3462,6785,1996
64074,Waremme,6209,6709,12918,1996
64075,Wasseiges,1029,1071,2100,1996
64076,Faimes,1532,1520,3052,1996
70000,Province de Limbourg,388367,386935,775302,1996
71000,Arrondissement de Hasselt,187403,188416,375819,1996
71002,As,3536,3494,7030,1996
71004,Beringen,19146,19084,38230,1996
71011,Diepenbeek,8455,8258,16713,1996
71016,Genk,30984,31158,62142,1996
71017,Gingelom,3660,3795,7455,1996
71020,Halen,4014,3991,8005,1996
71022,Hasselt,32960,34496,67456,1996
71024,Herck-la-Ville,5643,5739,11382,1996
71034,Bourg-Léopold,6849,6870,13719,1996
71037,Lummen,6708,6560,13268,1996
71045,Nieuwerkerken (Hasselt),3113,3064,6177,1996
71047,Opglabbeek,4379,4277,8656,1996
71053,Saint-Trond,18392,18889,37281,1996
71057,Tessenderlo,7541,7469,15010,1996
71066,Zonhoven,9306,9122,18428,1996
71067,Zutendaal,3273,3204,6477,1996
71069,Ham,4531,4435,8966,1996
71070,Heusden-Zolder,14913,14511,29424,1996
72000,Arrondissement de Maaseik,107532,104784,212316,1996
72003,Bocholt,5723,5708,11431,1996
72004,Bree,6854,6834,13688,1996
72018,Kinrooi,5856,5549,11405,1996
72020,Lommel,14837,14541,29378,1996
72021,Maaseik,11225,10928,22153,1996
72025,Neerpelt,7553,7403,14956,1996
72029,Overpelt,6138,6000,12138,1996
72030,Peer,7550,7217,14767,1996
72037,Hamont-Achel,6746,6458,13204,1996
72038,Hechtel-Eksel,5511,5317,10828,1996
72039,Houthalen-Helchteren,14486,14167,28653,1996
72040,Meeuwen-Gruitrode,6200,5998,12198,1996
72041,Dilsen-Stokkem,8853,8664,17517,1996
73000,Arrondissement de Tongres,93432,93735,187167,1996
73001,Alken,5325,5356,10681,1996
73006,Bilzen,14300,14339,28639,1996
73009,Looz,4877,5072,9949,1996
73022,Heers,3285,3238,6523,1996
73028,Herstappe,44,46,90,1996
73032,Hoeselt,4522,4434,8956,1996
73040,Kortessem,3933,3983,7916,1996
73042,Lanaken,11658,11332,22990,1996
73066,Riemst,7688,7593,15281,1996
73083,Tongres,14625,15173,29798,1996
73098,Wellen,3302,3220,6522,1996
73107,Maasmechelen,17686,17819,35505,1996
73109,Fourons,2187,2130,4317,1996
80000,Province de Luxembourg,118814,122524,241338,1996
81000,Arrondissement d'Arlon,25175,25837,51012,1996
81001,Arlon,12079,12338,24417,1996
81003,Attert,1879,1875,3754,1996
81004,Aubange,7095,7441,14536,1996
81013,Martelange,750,763,1513,1996
81015,Messancy,3372,3420,6792,1996
82000,Arrondissement de Bastogne,19416,19794,39210,1996
82003,Bastogne,6281,6536,12817,1996
82005,Bertogne,1322,1282,2604,1996
82009,Fauvillers,881,878,1759,1996
82014,Houffalize,2185,2276,4461,1996
82032,Vielsalm,3458,3574,7032,1996
82036,Vaux-sur-Sûre,1991,1907,3898,1996
82037,Gouvy,2230,2217,4447,1996
82038,Sainte-Ode,1068,1124,2192,1996
83000,Arrondissement de Marche-en-Famenne,23906,24667,48573,1996
83012,Durbuy,4577,4748,9325,1996
83013,Erezée,1314,1288,2602,1996
83028,Hotton,2285,2321,4606,1996
83031,La Roche-en-Ardenne,2017,2039,4056,1996
83034,Marche-en-Famenne,7724,8180,15904,1996
83040,Nassogne,2306,2357,4663,1996
83044,Rendeux,1068,1095,2163,1996
83049,Tenneville,1176,1232,2408,1996
83055,Manhay,1439,1407,2846,1996
84000,Arrondissement de Neufchâteau,26948,28043,54991,1996
84009,Bertrix,3897,4069,7966,1996
84010,Bouillon,2709,2843,5552,1996
84016,Daverdisse,686,745,1431,1996
84029,Herbeumont,707,720,1427,1996
84033,Léglise,1786,1769,3555,1996
84035,Libin,2074,2157,4231,1996
84043,Neufchâteau (Neufchâteau),3024,3109,6133,1996
84050,Paliseul,2376,2477,4853,1996
84059,Saint-Hubert,2802,2926,5728,1996
84068,Tellin,1042,1127,2169,1996
84075,Wellin,1399,1427,2826,1996
84077,Libramont-Chevigny,4446,4674,9120,1996
85000,Arrondissement de Virton,23369,24183,47552,1996
85007,Chiny,2381,2384,4765,1996
85009,Etalle,2201,2205,4406,1996
85011,Florenville,2743,2941,5684,1996
85024,Meix-devant-Virton,1337,1387,2724,1996
85026,Musson,1922,1922,3844,1996
85034,Saint-Léger (Virton),1557,1541,3098,1996
85039,Tintigny,1674,1760,3434,1996
85045,Virton,5267,5729,10996,1996
85046,Habay,3358,3368,6726,1996
85047,Rouvroy,929,946,1875,1996
90000,Province de Namur,211986,223691,435677,1996
91000,Arrondissement de Dinant,47486,49791,97277,1996
91005,Anhée,3189,3417,6606,1996
91013,Beauraing,3792,4160,7952,1996
91015,Bièvre,1545,1524,3069,1996
91030,Ciney,6951,7345,14296,1996
91034,Dinant,6013,6507,12520,1996
91054,Gedinne,2100,2210,4310,1996
91059,Hamois,3085,3143,6228,1996
91064,Havelange,2171,2331,4502,1996
91072,Houyet,2116,2195,4311,1996
91103,Onhaye,1463,1506,2969,1996
91114,Rochefort,5723,5891,11614,1996
91120,Somme-Leuze,1898,1895,3793,1996
91141,Yvoir,3670,3869,7539,1996
91142,Hastière,2404,2411,4815,1996
91143,Vresse-sur-Semois,1366,1387,2753,1996
92000,Arrondissement de Namur,134819,143051,277870,1996
92003,Andenne,11387,11977,23364,1996
92006,Assesse,2890,2830,5720,1996
92035,Eghezée,6271,6476,12747,1996
92045,Floreffe,3383,3521,6904,1996
92048,Fosses-la-Ville,4278,4268,8546,1996
92054,Gesves,2621,2653,5274,1996
92087,Mettet,5341,5428,10769,1996
92094,Namur,50147,54912,105059,1996
92097,Ohey,1907,1968,3875,1996
92101,Profondeville,5008,5261,10269,1996
92114,Sombreffe,3379,3565,6944,1996
92137,Sambreville,13127,14242,27369,1996
92138,Fernelmont,2965,3129,6094,1996
92140,Jemeppe-sur-Sambre,8381,8808,17189,1996
92141,La Bruyère,3718,3837,7555,1996
92142,Gembloux,10016,10176,20192,1996
93000,Arrondissement de Philippeville,29681,30849,60530,1996
93010,Cerfontaine,2024,2142,4166,1996
93014,Couvin,6379,6676,13055,1996
93018,Doische,1479,1431,2910,1996
93022,Florennes,5294,5369,10663,1996
93056,Philippeville,3785,3858,7643,1996
93088,Walcourt,7954,8451,16405,1996
93090,Viroinval,2766,2922,5688,1996
