code_ins,lieu_de_residence,hommes,femmes,total,annee
01000,Belgique,4899232,5122765,10021997,1992
02000,Région flamande,2862226,2932631,5794857,1992
03000,Région wallonne,1588329,1687594,3275923,1992
04000,Région de Bruxelles-Capitale,448677,502540,951217,1992
10000,Province d'Anvers,794297,816398,1610695,1992
11000,Arrondissement d'Anvers,453364,474716,928080,1992
11001,Aartselaar,7076,7233,14309,1992
11002,Anvers,224552,241231,465783,1992
11004,Boechout,5653,5656,11309,1992
11005,Boom,6747,7190,13937,1992
11007,Borsbeek,4935,5139,10074,1992
11008,Brasschaat,17560,17998,35558,1992
11009,Brecht,10954,10609,21563,1992
11013,Edegem,11324,11835,23159,1992
11016,Essen,7380,7349,14729,1992
11018,Hemiksem,4635,4704,9339,1992
11021,Hove (Anvers),3976,4132,8108,1992
11022,Kalmthout,7986,8133,16119,1992
11023,Kapellen (Anvers),12080,12486,24566,1992
11024,Kontich,9399,9447,18846,1992
11025,Lint,3477,3521,6998,1992
11029,Mortsel,12546,13313,25859,1992
11030,Niel,3860,3990,7850,1992
11035,Ranst,8282,8108,16390,1992
11037,Rumst,7067,7013,14080,1992
11038,Schelle,3540,3509,7049,1992
11039,Schilde,9405,9558,18963,1992
11040,Schoten,15261,15985,31246,1992
11044,Stabroek,8233,8249,16482,1992
11050,Wijnegem,4053,4368,8421,1992
11052,Wommelgem,5519,5830,11349,1992
11053,Wuustwezel,7931,7621,15552,1992
11054,Zandhoven,5558,5531,11089,1992
11055,Zoersel,9127,9429,18556,1992
11056,Zwijndrecht,8944,9257,18201,1992
11057,Malle,6304,6292,12596,1992
12000,Arrondissement de Malines,146528,150640,297168,1992
12002,Berlaar,4813,4946,9759,1992
12005,Bonheiden,6384,6609,12993,1992
12007,Bornem,9527,9513,19040,1992
12009,Duffel,7253,7968,15221,1992
12014,Heist-op-den-Berg,17998,17738,35736,1992
12021,Lierre,15264,16129,31393,1992
12025,Malines,36722,38967,75689,1992
12026,Nijlen,9928,9732,19660,1992
12029,Putte,7426,7361,14787,1992
12030,Puurs,7609,7524,15133,1992
12034,Sint-Amands,3657,3609,7266,1992
12035,Sint-Katelijne-Waver,9009,9303,18312,1992
12040,Willebroek,10938,11241,22179,1992
13000,Arrondissement de Turnhout,194405,191042,385447,1992
13001,Arendonk,5675,5528,11203,1992
13002,Baerle-Duc,1085,1011,2096,1992
13003,Balen,9581,9121,18702,1992
13004,Beerse,7205,7114,14319,1992
13006,Dessel,4221,4057,8278,1992
13008,Geel,16415,16226,32641,1992
13010,Grobbendonk,4928,4888,9816,1992
13011,Herentals,12138,12362,24500,1992
13012,Herenthout,4028,3857,7885,1992
13013,Herselt,6604,6237,12841,1992
13014,Hoogstraten,8101,7807,15908,1992
13016,Hulshout,3846,3762,7608,1992
13017,Kasterlee,8340,7975,16315,1992
13019,Lille,7041,6768,13809,1992
13021,Meerhout,4619,4519,9138,1992
13023,Merksplas,3761,3637,7398,1992
13025,Mol,15425,15326,30751,1992
13029,Olen,5199,5231,10430,1992
13031,Oud-Turnhout,5826,5851,11677,1992
13035,Ravels,5946,5802,11748,1992
13036,Retie,4686,4444,9130,1992
13037,Rijkevorsel,4991,4739,9730,1992
13040,Turnhout,18742,19340,38082,1992
13044,Vorselaar,3450,3497,6947,1992
13046,Vosselaar,4787,4711,9498,1992
13049,Westerlo,10543,10183,20726,1992
13053,Laakdal,7222,7049,14271,1992
20001,Province du Brabant flamand,480439,496517,976956,1992
20002,Province du Brabant wallon,159145,166476,325621,1992
21000,Arrondissement de Bruxelles-Capitale,448677,502540,951217,1992
21001,Anderlecht,41914,46217,88131,1992
21002,Auderghem,13418,15612,29030,1992
21003,Berchem-Sainte-Agathe,8555,9884,18439,1992
21004,Bruxelles,66014,69421,135435,1992
21005,Etterbeek,17668,21136,38804,1992
21006,Evere,13470,15816,29286,1992
21007,Forest (Bruxelles-Capitale),21404,24553,45957,1992
21008,Ganshoren,9099,11190,20289,1992
21009,Ixelles,34645,37802,72447,1992
21010,Jette,17753,20887,38640,1992
21011,Koekelberg,7557,8466,16023,1992
21012,Molenbeek-Saint-Jean,32753,35240,67993,1992
21013,Saint-Gilles,20893,21486,42379,1992
21014,Saint-Josse-ten-Noode,10707,10956,21663,1992
21015,Schaerbeek,48947,53470,102417,1992
21016,Uccle,33660,40166,73826,1992
21017,Watermael-Boitsfort,11304,13291,24595,1992
21018,Woluwe-Saint-Lambert,21304,26443,47747,1992
21019,Woluwe-Saint-Pierre,17612,20504,38116,1992
23000,Arrondissement de Hal-Vilvorde,265216,275915,541131,1992
23002,Asse,13311,13871,27182,1992
23003,Beersel,10973,11338,22311,1992
23009,Biévène,900,927,1827,1992
23016,Dilbeek,18196,18987,37183,1992
23023,Gammerages,3645,3679,7324,1992
23024,Gooik,4107,4114,8221,1992
23025,Grimbergen,15646,16718,32364,1992
23027,Hal (Hal-Vilvorde),16164,16835,32999,1992
23032,Herne,3028,3105,6133,1992
23033,Hoeilaart,4681,4854,9535,1992
23038,Kampenhout,4984,5128,10112,1992
23039,Kapelle-op-den-Bos,4348,4376,8724,1992
23044,Liedekerke,5675,5855,11530,1992
23045,Londerzeel,8422,8571,16993,1992
23047,Machelen (Hal-Vilvorde),5488,5841,11329,1992
23050,Meise,8501,8692,17193,1992
23052,Merchtem,6608,6684,13292,1992
23060,Opwijk,5710,5860,11570,1992
23062,Overijse,11321,11790,23111,1992
23064,Pepingen,1951,1937,3888,1992
23077,Sint-Pieters-Leeuw,14333,14954,29287,1992
23081,Steenokkerzeel,4949,5109,10058,1992
23086,Ternat,6772,6769,13541,1992
23088,Vilvorde,15983,17045,33028,1992
23094,Zaventem,12664,13417,26081,1992
23096,Zemst,9467,9729,19196,1992
23097,Roosdaal,5054,5181,10235,1992
23098,Drogenbos,2293,2499,4792,1992
23099,Kraainem,6151,6415,12566,1992
23100,Linkebeek,2266,2326,4592,1992
23101,Rhode-Saint-Genèse,8762,9098,17860,1992
23102,Wemmel,6622,7241,13863,1992
23103,Wezembeek-Oppem,6448,6813,13261,1992
23104,Lennik,4066,4207,8273,1992
23105,Affligem,5727,5950,11677,1992
24000,Arrondissement de Louvain,215223,220602,435825,1992
24001,Aarschot,13186,13310,26496,1992
24007,Begijnendijk,4181,4189,8370,1992
24008,Bekkevoort,2767,2697,5464,1992
24009,Bertem,4177,4352,8529,1992
24011,Bierbeek,4295,4363,8658,1992
24014,Boortmeerbeek,5413,5376,10789,1992
24016,Boutersem,3378,3322,6700,1992
24020,Diest,10671,10825,21496,1992
24028,Geetbets,2830,2823,5653,1992
24033,Haacht,6093,6204,12297,1992
24038,Herent,8748,8925,17673,1992
24041,Hoegaarden,2713,2899,5612,1992
24043,Holsbeek,3989,3888,7877,1992
24045,Huldenberg,3919,4154,8073,1992
24048,Keerbergen,5454,5460,10914,1992
24054,Kortenaken,3748,3638,7386,1992
24055,Kortenberg,7899,8195,16094,1992
24059,Landen,6934,7264,14198,1992
24062,Louvain,41356,44217,85573,1992
24066,Lubbeek,6372,6319,12691,1992
24086,Oud-Heverlee,5084,5067,10151,1992
24094,Rotselaar,6527,6519,13046,1992
24104,Tervuren,9583,9858,19441,1992
24107,Tirlemont,15347,16219,31566,1992
24109,Tremelo,5968,5825,11793,1992
24130,Léau,3883,3865,7748,1992
24133,Linter,3220,3306,6526,1992
24134,Montaigu-Zichem,10405,10506,20911,1992
24135,Tielt-Winge,4607,4633,9240,1992
24137,Glabbeek,2476,2384,4860,1992
25000,Arrondissement de Nivelles,159145,166476,325621,1992
25005,Beauvechain,2926,2879,5805,1992
25014,Braine-l'Alleud,16071,17022,33093,1992
25015,Braine-le-Château,4036,4213,8249,1992
25018,Chaumont-Gistoux,4360,4454,8814,1992
25023,Court-Saint-Etienne,3888,4009,7897,1992
25031,Genappe,6425,6543,12968,1992
25037,Grez-Doiceau,5216,5454,10670,1992
25043,Incourt,1740,1792,3532,1992
25044,Ittre,2539,2614,5153,1992
25048,Jodoigne,4912,5303,10215,1992
25050,La Hulpe,3388,3644,7032,1992
25068,Mont-Saint-Guibert,2553,2589,5142,1992
25072,Nivelles,11219,12135,23354,1992
25084,Perwez (Nivelles),3121,3249,6370,1992
25091,Rixensart,10210,10831,21041,1992
25105,Tubize,10157,10558,20715,1992
25107,Villers-la-Ville,4108,4202,8310,1992
25110,Waterloo,13458,14459,27917,1992
25112,Wavre,13989,14918,28907,1992
25117,Chastre,2796,3000,5796,1992
25118,Hélécine,1414,1433,2847,1992
25119,Lasne,6382,6440,12822,1992
25120,Orp-Jauche,3185,3410,6595,1992
25121,Ottignies-Louvain-la-Neuve,11837,11737,23574,1992
25122,Ramillies,2326,2355,4681,1992
25123,Rebecq,4478,4808,9286,1992
25124,Walhain,2411,2425,4836,1992
30000,Province de Flandre occidentale,548430,563127,1111557,1992
31000,Arrondissement de Bruges,130170,134960,265130,1992
31003,Beernem,7231,6884,14115,1992
31004,Blankenberge,7985,8764,16749,1992
31005,Bruges,56666,60051,116717,1992
31006,Damme,5359,5347,10706,1992
31012,Jabbeke,6282,6224,12506,1992
31022,Oostkamp,10306,10329,20635,1992
31033,Torhout,9160,9158,18318,1992
31040,Zedelgem,10396,10329,20725,1992
31042,Zuienkerke,1375,1319,2694,1992
31043,Knokke-Heist,15410,16555,31965,1992
32000,Arrondissement de Dixmude,23787,23655,47442,1992
32003,Dixmude,7643,7630,15273,1992
32006,Houthulst,4396,4437,8833,1992
32010,Koekelare,3983,3900,7883,1992
32011,Kortemark,6188,6123,12311,1992
32030,Lo-Reninge,1577,1565,3142,1992
33000,Arrondissement d'Ypres,51528,52514,104042,1992
33011,Ypres,17266,18016,35282,1992
33016,Messines,521,510,1031,1992
33021,Poperinge,9565,9762,19327,1992
33029,Wervik,8812,9112,17924,1992
33037,Zonnebeke,5547,5483,11030,1992
33039,Heuvelland,4291,4166,8457,1992
33040,Langemark-Poelkapelle,3725,3656,7381,1992
33041,Vleteren,1801,1809,3610,1992
34000,Arrondissement de Courtrai,137085,140288,277373,1992
34002,Anzegem,6598,6586,13184,1992
34003,Avelgem,4423,4556,8979,1992
34009,Deerlijk,5674,5667,11341,1992
34013,Harelbeke,12945,13007,25952,1992
34022,Courtrai,37317,39068,76385,1992
34023,Kuurne,6342,6342,12684,1992
34025,Lendelede,2732,2776,5508,1992
34027,Menin,15929,16720,32649,1992
34040,Waregem,17447,17649,35096,1992
34041,Wevelgem,15305,15441,30746,1992
34042,Zwevegem,11482,11572,23054,1992
34043,Espierres-Helchin,891,904,1795,1992
35000,Arrondissement d'Ostende,67688,71280,138968,1992
35002,Bredene,6232,6234,12466,1992
35005,Gistel,4989,5144,10133,1992
35006,Ichtegem,6543,6365,12908,1992
35011,Middelkerke,7720,7849,15569,1992
35013,Ostende,32893,36064,68957,1992
35014,Oudenburg,4172,4167,8339,1992
35029,De Haan,5139,5457,10596,1992
36000,Arrondissement de Roulers,68712,69693,138405,1992
36006,Hooglede,4717,4541,9258,1992
36007,Ingelmunster,5205,5289,10494,1992
36008,Izegem,12957,13545,26502,1992
36010,Ledegem,4735,4675,9410,1992
36011,Lichtervelde,3998,4015,8013,1992
36012,Moorslede,5400,5343,10743,1992
36015,Roulers,26280,26900,53180,1992
36019,Staden,5420,5385,10805,1992
37000,Arrondissement de Tielt,43145,43227,86372,1992
37002,Dentergem,3743,3828,7571,1992
37007,Meulebeke,5362,5455,10817,1992
37010,Oostrozebeke,3536,3481,7017,1992
37011,Pittem,3253,3263,6516,1992
37012,Ruiselede,2474,2478,4952,1992
37015,Tielt (Tielt),9606,9797,19403,1992
37017,Wielsbeke,4241,4193,8434,1992
37018,Wingene,6047,5941,11988,1992
37020,Ardooie,4883,4791,9674,1992
38000,Arrondissement de Furnes,26315,27510,53825,1992
38002,Alveringem,2509,2404,4913,1992
38008,La Panne,4649,5137,9786,1992
38014,Koksijde,8895,9285,18180,1992
38016,Nieuport,4770,4948,9718,1992
38025,Furnes,5492,5736,11228,1992
40000,Province de Flandre orientale,659932,680124,1340056,1992
41000,Arrondissement d'Alost,127609,131635,259244,1992
41002,Alost (Alost),37482,38971,76453,1992
41011,Denderleeuw,8283,8448,16731,1992
41018,Grammont,14955,15466,30421,1992
41024,Haaltert,8407,8516,16923,1992
41027,Herzele,7828,7926,15754,1992
41034,Lede,8320,8663,16983,1992
41048,Ninove,16658,17009,33667,1992
41063,Sint-Lievens-Houtem,4374,4551,8925,1992
41081,Zottegem,11946,12634,24580,1992
41082,Erpe-Mere,9356,9451,18807,1992
42000,Arrondissement de Termonde,91122,92158,183280,1992
42003,Berlare,6456,6382,12838,1992
42004,Buggenhout,6750,6728,13478,1992
42006,Termonde,20939,21636,42575,1992
42008,Hamme (Termonde),11467,11348,22815,1992
42010,Laarne,5771,5768,11539,1992
42011,Lebbeke,8442,8350,16792,1992
42023,Waasmunster,4742,4821,9563,1992
42025,Wetteren,11062,11652,22714,1992
42026,Wichelen,5397,5434,10831,1992
42028,Zele,10096,10039,20135,1992
43000,Arrondissement d'Eeklo,39430,39486,78916,1992
43002,Assenede,6682,6779,13461,1992
43005,Eeklo,9359,9723,19082,1992
43007,Kaprijke,3103,3038,6141,1992
43010,Maldegem,10792,10597,21389,1992
43014,Sint-Laureins,3323,3189,6512,1992
43018,Zelzate,6171,6160,12331,1992
44000,Arrondissement de Gand,238864,249899,488763,1992
44001,Aalter,8497,8512,17009,1992
44011,Deinze,12867,13221,26088,1992
44012,De Pinte,4799,4903,9702,1992
44013,Destelbergen,8397,8620,17017,1992
44019,Evergem,14697,14937,29634,1992
44020,Gavere,5359,5519,10878,1992
44021,Gand,111171,119061,230232,1992
44029,Knesselare,3877,3918,7795,1992
44034,Lochristi,8710,8713,17423,1992
44036,Lovendegem,4437,4622,9059,1992
44040,Melle,4736,5215,9951,1992
44043,Merelbeke,10026,10431,20457,1992
44045,Moerbeke (Gand),2766,2825,5591,1992
44048,Nazareth,4876,5002,9878,1992
44049,Nevele,5233,5331,10564,1992
44052,Oosterzele,6221,6435,12656,1992
44064,Sint-Martens-Latem,4069,4186,8255,1992
44072,Waarschoot,3807,3926,7733,1992
44073,Wachtebeke,3430,3562,6992,1992
44080,Zomergem,4012,4101,8113,1992
44081,Zulte,6877,6859,13736,1992
45000,Arrondissement d'Audenarde,55442,57330,112772,1992
45017,Kruishoutem,3838,3688,7526,1992
45035,Audenarde,13213,13889,27102,1992
45041,Renaix,11678,12474,24152,1992
45057,Zingem,3249,3298,6547,1992
45059,Brakel,6615,7007,13622,1992
45060,Kluisbergen,3059,3082,6141,1992
45061,Wortegem-Petegem,2941,2938,5879,1992
45062,Horebeke,941,934,1875,1992
45063,Lierde,3099,3060,6159,1992
45064,Maarkedal,3107,3214,6321,1992
45065,Zwalm,3702,3746,7448,1992
46000,Arrondissement de Saint-Nicolas,107465,109616,217081,1992
46003,Beveren (Saint-Nicolas),21505,21641,43146,1992
46013,Kruibeke,7242,7167,14409,1992
46014,Lokeren,17257,17864,35121,1992
46020,Sint-Gillis-Waas,8168,8169,16337,1992
46021,Saint-Nicolas (Saint-Nicolas),33307,34946,68253,1992
46024,Stekene,7960,7828,15788,1992
46025,Tamise,12026,12001,24027,1992
50000,Province de Hainaut,618823,664429,1283252,1992
51000,Arrondissement d'Ath,37691,39480,77171,1992
51004,Ath,11801,12438,24239,1992
51008,Beloeil,6528,6679,13207,1992
51009,Bernissart,5596,5867,11463,1992
51012,Brugelette,1575,1690,3265,1992
51014,Chièvres,2852,3014,5866,1992
51017,Ellezelles,2652,2789,5441,1992
51019,Flobecq,1415,1583,2998,1992
51065,Frasnes-lez-Anvaing,5272,5420,10692,1992
52000,Arrondissement de Charleroi,205251,222297,427548,1992
52010,Chapelle-lez-Herlaimont,6814,7377,14191,1992
52011,Charleroi,98730,108173,206903,1992
52012,Châtelet,17554,19134,36688,1992
52015,Courcelles,14181,15268,29449,1992
52018,Farciennes,5843,6136,11979,1992
52021,Fleurus,10830,11692,22522,1992
52022,Fontaine-l'Evêque,8410,9166,17576,1992
52025,Gerpinnes,5612,5879,11491,1992
52043,Manage,10511,11187,21698,1992
52048,Montigny-le-Tilleul,4884,5308,10192,1992
52055,Pont-à-Celles,7561,7865,15426,1992
52063,Seneffe,5001,5226,10227,1992
52074,Aiseau-Presles,5300,5624,10924,1992
52075,Les Bons Villers,4020,4262,8282,1992
53000,Arrondissement de Mons,120988,132192,253180,1992
53014,Boussu,9932,10753,20685,1992
53020,Dour,8272,9009,17281,1992
53028,Frameries,10071,11249,21320,1992
53039,Hensies,3401,3463,6864,1992
53044,Jurbise,4043,4422,8465,1992
53046,Lens,1818,1880,3698,1992
53053,Mons,43809,48619,92428,1992
53065,Quaregnon,9499,10158,19657,1992
53068,Quiévrain,3374,3562,6936,1992
53070,Saint-Ghislain,10498,11631,22129,1992
53082,Colfontaine,10263,11213,21476,1992
53083,Honnelles,2429,2522,4951,1992
53084,Quévy,3579,3711,7290,1992
54000,Arrondissement de Mouscron,34741,36856,71597,1992
54007,Mouscron,25993,27781,53774,1992
54010,Comines-Warneton,8748,9075,17823,1992
55000,Arrondissement de Soignies,81871,87083,168954,1992
55004,Braine-le-Comte,8692,9228,17920,1992
55010,Enghien,5060,5258,10318,1992
55022,La Louvière,37058,39636,76694,1992
55023,Lessines,7790,8383,16173,1992
55035,Le Roeulx,3893,3996,7889,1992
55039,Silly,3246,3283,6529,1992
55040,Soignies,11521,12433,23954,1992
55050,Ecaussinnes,4611,4866,9477,1992
56000,Arrondissement de Thuin,69945,74088,144033,1992
56001,Anderlues,5516,5906,11422,1992
56005,Beaumont,3025,3234,6259,1992
56011,Binche,15865,17043,32908,1992
56016,Chimay,4710,4954,9664,1992
56022,Erquelinnes,4652,4993,9645,1992
56029,Froidchapelle,1402,1446,2848,1992
56044,Lobbes,2610,2723,5333,1992
56049,Merbes-le-Château,1979,2039,4018,1992
56051,Momignies,2512,2594,5106,1992
56078,Thuin,6987,7337,14324,1992
56085,Estinnes,3514,3690,7204,1992
56086,Ham-sur-Heure-Nalinnes,6182,6510,12692,1992
56087,Morlanwelz,8768,9349,18117,1992
56088,Sivry-Rance,2223,2270,4493,1992
57000,Arrondissement de Tournai,68336,72433,140769,1992
57003,Antoing,3800,3990,7790,1992
57018,Celles (Tournai),2692,2730,5422,1992
57027,Estaimpuis,4652,4871,9523,1992
57062,Pecq,2525,2612,5137,1992
57064,Péruwelz,8063,8463,16526,1992
57072,Rumes,2543,2616,5159,1992
57081,Tournai,32652,35124,67776,1992
57093,Brunehaut,3679,3837,7516,1992
57094,Leuze-en-Hainaut,6222,6671,12893,1992
57095,Mont-de-l'Enclus,1508,1519,3027,1992
60000,Province de Liège,487615,518466,1006081,1992
61000,Arrondissement de Huy,46207,48522,94729,1992
61003,Amay,6197,6626,12823,1992
61010,Burdinne,1192,1225,2417,1992
61012,Clavier,1902,1947,3849,1992
61019,Ferrières,1913,1984,3897,1992
61024,Hamoir,1647,1730,3377,1992
61028,Héron,1897,1977,3874,1992
61031,Huy,8787,9585,18372,1992
61039,Marchin,2405,2448,4853,1992
61041,Modave,1651,1655,3306,1992
61043,Nandrin,2217,2263,4480,1992
61048,Ouffet,1255,1231,2486,1992
61063,Verlaine,1499,1535,3034,1992
61068,Villers-Le-Bouillet,2472,2567,5039,1992
61072,Wanze,5604,6002,11606,1992
61079,Anthisnes,1773,1845,3618,1992
61080,Engis,2842,2895,5737,1992
61081,Tinlot,954,1007,1961,1992
62000,Arrondissement de Liège,284866,307111,591977,1992
62003,Ans,13227,14344,27571,1992
62006,Awans,3749,4090,7839,1992
62009,Aywaille,4552,4724,9276,1992
62011,Bassenge,3922,4060,7982,1992
62015,Beyne-Heusay,5455,5803,11258,1992
62022,Chaudfontaine,9909,10609,20518,1992
62026,Comblain-au-Pont,2484,2650,5134,1992
62027,Dalhem,2938,2942,5880,1992
62032,Esneux,6182,6590,12772,1992
62038,Fléron,7548,8327,15875,1992
62051,Herstal,17488,19026,36514,1992
62060,Juprelle,3752,3897,7649,1992
62063,Liège,93788,102515,196303,1992
62079,Oupeye,11227,12132,23359,1992
62093,Saint-Nicolas (Liège),11413,12353,23766,1992
62096,Seraing,29113,32069,61182,1992
62099,Soumagne,6799,6982,13781,1992
62100,Sprimont,5511,5719,11230,1992
62108,Visé,8327,8697,17024,1992
62118,Grâce-Hollogne,10818,11425,22243,1992
62119,Blégny,5831,5908,11739,1992
62120,Flémalle,12675,13806,26481,1992
62121,Neupré,4407,4529,8936,1992
62122,Trooz,3751,3914,7665,1992
63000,Arrondissement de Verviers,125471,130144,255615,1992
63001,Amblève,2446,2328,4774,1992
63003,Aubel,1801,1853,3654,1992
63004,Baelen,1653,1706,3359,1992
63012,Bullange,2633,2547,5180,1992
63013,Butgenbach,2609,2521,5130,1992
63020,Dison,6920,7149,14069,1992
63023,Eupen,8367,8926,17293,1992
63035,Herve,7717,8027,15744,1992
63038,Jalhay,3218,3197,6415,1992
63040,La Calamine,4852,4886,9738,1992
63045,Lierneux,1620,1581,3201,1992
63046,Limbourg,2579,2682,5261,1992
63048,Lontzen,2225,2258,4483,1992
63049,Malmedy,5027,5391,10418,1992
63057,Olne,1705,1712,3417,1992
63058,Pepinster,4433,4623,9056,1992
63061,Raeren,4614,4604,9218,1992
63067,Saint-Vith,4276,4370,8646,1992
63072,Spa,4881,5389,10270,1992
63073,Stavelot,3103,3190,6293,1992
63075,Stoumont,1313,1345,2658,1992
63076,Theux,4997,5147,10144,1992
63079,Verviers,25809,27949,53758,1992
63080,Waimes,3040,2948,5988,1992
63084,Welkenraedt,4087,4225,8312,1992
63086,Trois-Ponts,1052,1178,2230,1992
63087,Burg-Reuland,1897,1825,3722,1992
63088,Plombières,4395,4374,8769,1992
63089,Thimister-Clermont,2202,2213,4415,1992
64000,Arrondissement de Waremme,31071,32689,63760,1992
64008,Berloz,1180,1201,2381,1992
64015,Braives,2412,2538,4950,1992
64021,Crisnée,1136,1159,2295,1992
64023,Donceel,1137,1170,2307,1992
64025,Fexhe-le-Haut-Clocher,1321,1433,2754,1992
64029,Geer,1206,1247,2453,1992
64034,Hannut,5884,6272,12156,1992
64047,Lincent,1317,1396,2713,1992
64056,Oreye,1569,1636,3205,1992
64063,Remicourt,2168,2325,4493,1992
64065,Saint-Georges-sur-Meuse,3252,3389,6641,1992
64074,Waremme,6120,6529,12649,1992
64075,Wasseiges,938,971,1909,1992
64076,Faimes,1431,1423,2854,1992
70000,Province de Limbourg,379128,376465,755593,1992
71000,Arrondissement de Hasselt,183671,184070,367741,1992
71002,As,3394,3356,6750,1992
71004,Beringen,18531,18362,36893,1992
71011,Diepenbeek,8250,8020,16270,1992
71016,Genk,30780,30809,61589,1992
71017,Gingelom,3617,3704,7321,1992
71020,Halen,3907,3858,7765,1992
71022,Hasselt,32710,34174,66884,1992
71024,Herck-la-Ville,5415,5484,10899,1992
71034,Bourg-Léopold,6791,6864,13655,1992
71037,Lummen,6495,6241,12736,1992
71045,Nieuwerkerken (Hasselt),3036,2944,5980,1992
71047,Opglabbeek,4142,3999,8141,1992
71053,Saint-Trond,18274,18789,37063,1992
71057,Tessenderlo,7297,7269,14566,1992
71066,Zonhoven,8824,8768,17592,1992
71067,Zutendaal,3158,3005,6163,1992
71069,Ham,4445,4363,8808,1992
71070,Heusden-Zolder,14605,14061,28666,1992
72000,Arrondissement de Maaseik,103709,100728,204437,1992
72003,Bocholt,5543,5445,10988,1992
72004,Bree,6859,6830,13689,1992
72018,Kinrooi,5609,5327,10936,1992
72020,Lommel,14315,13908,28223,1992
72021,Maaseik,10920,10554,21474,1992
72025,Neerpelt,7209,7040,14249,1992
72029,Overpelt,5965,5825,11790,1992
72030,Peer,7054,6797,13851,1992
72037,Hamont-Achel,6485,6191,12676,1992
72038,Hechtel-Eksel,5187,4948,10135,1992
72039,Houthalen-Helchteren,14035,13682,27717,1992
72040,Meeuwen-Gruitrode,5904,5750,11654,1992
72041,Dilsen-Stokkem,8624,8431,17055,1992
73000,Arrondissement de Tongres,91748,91667,183415,1992
73001,Alken,5157,5108,10265,1992
73006,Bilzen,13838,13812,27650,1992
73009,Looz,4953,5104,10057,1992
73022,Heers,3259,3249,6508,1992
73028,Herstappe,46,47,93,1992
73032,Hoeselt,4420,4337,8757,1992
73040,Kortessem,3861,3898,7759,1992
73042,Lanaken,11380,11044,22424,1992
73066,Riemst,7666,7637,15303,1992
73083,Tongres,14491,14997,29488,1992
73098,Wellen,3274,3185,6459,1992
73107,Maasmechelen,17276,17150,34426,1992
73109,Fourons,2127,2099,4226,1992
80000,Province de Luxembourg,115480,119184,234664,1992
81000,Arrondissement d'Arlon,24377,25010,49387,1992
81001,Arlon,11684,11963,23647,1992
81003,Attert,1672,1656,3328,1992
81004,Aubange,7088,7375,14463,1992
81013,Martelange,717,740,1457,1992
81015,Messancy,3216,3276,6492,1992
82000,Arrondissement de Bastogne,18868,19179,38047,1992
82003,Bastogne,6061,6256,12317,1992
82005,Bertogne,1300,1230,2530,1992
82009,Fauvillers,883,861,1744,1992
82014,Houffalize,2096,2198,4294,1992
82032,Vielsalm,3393,3521,6914,1992
82036,Vaux-sur-Sûre,1895,1867,3762,1992
82037,Gouvy,2198,2186,4384,1992
82038,Sainte-Ode,1042,1060,2102,1992
83000,Arrondissement de Marche-en-Famenne,22954,23824,46778,1992
83012,Durbuy,4311,4515,8826,1992
83013,Erezée,1230,1192,2422,1992
83028,Hotton,2202,2260,4462,1992
83031,La Roche-en-Ardenne,1961,2036,3997,1992
83034,Marche-en-Famenne,7459,7977,15436,1992
83040,Nassogne,2224,2255,4479,1992
83044,Rendeux,1052,1059,2111,1992
83049,Tenneville,1145,1186,2331,1992
83055,Manhay,1370,1344,2714,1992
84000,Arrondissement de Neufchâteau,26519,27590,54109,1992
84009,Bertrix,3830,3987,7817,1992
84010,Bouillon,2704,2825,5529,1992
84016,Daverdisse,702,758,1460,1992
84029,Herbeumont,687,750,1437,1992
84033,Léglise,1735,1677,3412,1992
84035,Libin,2055,2166,4221,1992
84043,Neufchâteau (Neufchâteau),2962,3062,6024,1992
84050,Paliseul,2380,2457,4837,1992
84059,Saint-Hubert,2802,2888,5690,1992
84068,Tellin,1023,1102,2125,1992
84075,Wellin,1360,1435,2795,1992
84077,Libramont-Chevigny,4279,4483,8762,1992
85000,Arrondissement de Virton,22762,23581,46343,1992
85007,Chiny,2328,2360,4688,1992
85009,Etalle,1975,1984,3959,1992
85011,Florenville,2799,2923,5722,1992
85024,Meix-devant-Virton,1362,1363,2725,1992
85026,Musson,1880,1899,3779,1992
85034,Saint-Léger (Virton),1526,1525,3051,1992
85039,Tintigny,1639,1732,3371,1992
85045,Virton,5176,5676,10852,1992
85046,Habay,3149,3147,6296,1992
85047,Rouvroy,928,972,1900,1992
90000,Province de Namur,207266,219039,426305,1992
91000,Arrondissement de Dinant,46050,48432,94482,1992
91005,Anhée,3155,3428,6583,1992
91013,Beauraing,3902,4200,8102,1992
91015,Bièvre,1529,1503,3032,1992
91030,Ciney,6770,7261,14031,1992
91034,Dinant,5926,6375,12301,1992
91054,Gedinne,2064,2188,4252,1992
91059,Hamois,2912,2990,5902,1992
91064,Havelange,2129,2275,4404,1992
91072,Houyet,2067,2082,4149,1992
91103,Onhaye,1419,1474,2893,1992
91114,Rochefort,5556,5817,11373,1992
91120,Somme-Leuze,1608,1635,3243,1992
91141,Yvoir,3464,3621,7085,1992
91142,Hastière,2246,2241,4487,1992
91143,Vresse-sur-Semois,1303,1342,2645,1992
92000,Arrondissement de Namur,132008,140440,272448,1992
92003,Andenne,11289,11849,23138,1992
92006,Assesse,2815,2792,5607,1992
92035,Eghezée,5971,6224,12195,1992
92045,Floreffe,3250,3405,6655,1992
92048,Fosses-la-Ville,4014,4105,8119,1992
92054,Gesves,2454,2490,4944,1992
92087,Mettet,5169,5270,10439,1992
92094,Namur,49747,54557,104304,1992
92097,Ohey,1862,1929,3791,1992
92101,Profondeville,4829,4901,9730,1992
92114,Sombreffe,3270,3508,6778,1992
92137,Sambreville,13106,14156,27262,1992
92138,Fernelmont,2807,2932,5739,1992
92140,Jemeppe-sur-Sambre,8424,8876,17300,1992
92141,La Bruyère,3520,3678,7198,1992
92142,Gembloux,9481,9768,19249,1992
93000,Arrondissement de Philippeville,29208,30167,59375,1992
93010,Cerfontaine,2008,2106,4114,1992
93014,Couvin,6454,6610,13064,1992
93018,Doische,1401,1403,2804,1992
93022,Florennes,5272,5347,10619,1992
93056,Philippeville,3645,3672,7317,1992
93088,Walcourt,7746,8151,15897,1992
93090,Viroinval,2682,2878,5560,1992
